,State,City,Population,Total_law_enforcement_employees,Total_officers,Total_civilians
0,ALABAMA,Abbeville,2539.0,10,9,1
1,ALABAMA,Adamsville,4185.0,27,16,11
2,ALABAMA,Addison,714.0,5,4,1
3,ALABAMA,Alabaster,33963.0,87,69,18
4,ALABAMA,Albertville,21837.0,67,45,22
5,ALABAMA,Alexander City,14066.0,64,50,14
6,ALABAMA,Aliceville,2208.0,7,6,1
7,ALABAMA,Altoona,913.0,3,3,0
8,ALABAMA,Andalusia,8643.0,39,29,10
9,ALABAMA,Anniston,20913.0,82,76,6
10,ALABAMA,Arab,8437.0,35,26,9
11,ALABAMA,Ardmore,1548.0,11,7,4
12,ALABAMA,Argo,4306.0,7,7,0
13,ALABAMA,Arley,338.0,2,2,0
14,ALABAMA,Ashford,2206.0,6,5,1
15,ALABAMA,Ashland,1857.0,15,10,5
16,ALABAMA,Ashville,2412.0,4,4,0
17,ALABAMA,Athens,29411.0,59,48,11
18,ALABAMA,Atmore,8837.0,37,26,11
19,ALABAMA,Attalla,5804.0,26,20,6
20,ALABAMA,Auburn,70003.0,135,127,8
21,ALABAMA,Autaugaville,881.0,3,3,0
22,ALABAMA,Baker Hill,227.0,4,4,0
23,ALABAMA,Bay Minette,9647.0,30,21,9
24,ALABAMA,Bayou La Batre,2444.0,18,13,5
25,ALABAMA,Bear Creek,1061.0,3,3,0
26,ALABAMA,Berry,1080.0,4,4,0
27,ALABAMA,Bessemer,25911.0,147,103,44
28,ALABAMA,Birmingham,206476.0,951,756,195
29,ALABAMA,Blountsville,1654.0,5,5,0
30,ALABAMA,Boaz,9731.0,36,25,11
31,ALABAMA,Brantley,749.0,5,5,0
32,ALABAMA,Brent,4663.0,7,7,0
33,ALABAMA,Brewton,5116.0,26,19,7
34,ALABAMA,Bridgeport,2258.0,10,6,4
35,ALABAMA,Brighton,2805.0,9,5,4
36,ALABAMA,Brilliant,859.0,1,1,0
37,ALABAMA,Brookside,1318.0,17,9,8
38,ALABAMA,Brookwood,1833.0,8,8,0
39,ALABAMA,Brundidge,1855.0,10,6,4
40,ALABAMA,Butler,1670.0,10,8,2
41,ALABAMA,Calera,15654.0,44,35,9
42,ALABAMA,Camden,1667.0,11,10,1
43,ALABAMA,Camp Hill,927.0,4,4,0
44,ALABAMA,Carbon Hill,1872.0,11,5,6
45,ALABAMA,Carrollton,927.0,3,3,0
46,ALABAMA,Cedar Bluff,1830.0,5,5,0
47,ALABAMA,Centre,3624.0,14,13,1
48,ALABAMA,Centreville,2538.0,5,5,0
49,ALABAMA,Chatom,1157.0,3,3,0
50,ALABAMA,Cherokee,994.0,4,4,0
51,ALABAMA,Chickasaw,5618.0,20,20,0
52,ALABAMA,Childersburg,4747.0,14,13,1
53,ALABAMA,Citronelle,3867.0,29,13,16
54,ALABAMA,Clanton,8777.0,30,29,1
55,ALABAMA,Clayton,2814.0,2,2,0
56,ALABAMA,Cleveland,1316.0,2,2,0
57,ALABAMA,Clio,1258.0,5,5,0
58,ALABAMA,Coaling,1631.0,4,4,0
59,ALABAMA,Collinsville,1939.0,8,4,4
60,ALABAMA,Columbia,743.0,2,2,0
61,ALABAMA,Columbiana,4738.0,15,11,4
62,ALABAMA,Coosada,1325.0,5,5,0
63,ALABAMA,Cordova,1795.0,6,4,2
64,ALABAMA,Cottonwood,1244.0,3,3,0
65,ALABAMA,Courtland,579.0,1,1,0
66,ALABAMA,Creola,2043.0,8,7,1
67,ALABAMA,Crossville,1846.0,5,5,0
68,ALABAMA,Cuba,282.0,2,2,0
69,ALABAMA,Cullman,16696.0,58,51,7
70,ALABAMA,Dadeville,2988.0,15,14,1
71,ALABAMA,Daleville,5075.0,21,15,6
72,ALABAMA,Daphne,28387.0,89,62,27
73,ALABAMA,Dauphin Island,1380.0,14,8,6
74,ALABAMA,Decatur,54240.0,137,116,21
75,ALABAMA,Demopolis,6455.0,27,23,4
76,ALABAMA,Dora,1963.0,12,7,5
77,ALABAMA,Dothan,69747.0,224,158,66
78,ALABAMA,Double Springs,1057.0,10,8,2
79,ALABAMA,Douglas,784.0,5,5,0
80,ALABAMA,East Brewton,2311.0,9,5,4
81,ALABAMA,Eclectic,1011.0,9,9,0
82,ALABAMA,Elba,3916.0,15,7,8
83,ALABAMA,Elberta,1781.0,12,11,1
84,ALABAMA,Enterprise,29240.0,65,49,16
85,ALABAMA,Eufaula,11489.0,43,24,19
86,ALABAMA,Eutaw,2525.0,17,12,5
87,ALABAMA,Evergreen,3422.0,26,20,6
88,ALABAMA,Excel,610.0,3,3,0
89,ALABAMA,Fairfield,10397.0,11,5,6
90,ALABAMA,Fairhope,24467.0,67,44,23
91,ALABAMA,Falkville,1253.0,6,6,0
92,ALABAMA,Fayette,4214.0,11,11,0
93,ALABAMA,Flomaton,1371.0,12,8,4
94,ALABAMA,Florala,1882.0,5,5,0
95,ALABAMA,Florence,41325.0,139,108,31
96,ALABAMA,Foley,22166.0,93,63,30
97,ALABAMA,Fort Deposit,1126.0,2,2,0
98,ALABAMA,Fort Payne,14038.0,32,27,5
99,ALABAMA,Franklin,502.0,1,1,0
100,ALABAMA,Frisco City,1107.0,3,3,0
101,ALABAMA,Fultondale,9365.0,34,27,7
102,ALABAMA,Fyffe,1078.0,4,4,0
103,ALABAMA,Gadsden,34613.0,118,86,32
104,ALABAMA,Gantt,214.0,1,1,0
105,ALABAMA,Gardendale,14128.0,41,31,10
106,ALABAMA,Geneva,4246.0,13,10,3
107,ALABAMA,Georgiana,1601.0,8,5,3
108,ALABAMA,Geraldine,895.0,5,5,0
109,ALABAMA,Gilbertown,195.0,3,2,1
110,ALABAMA,Glencoe,5074.0,10,10,0
111,ALABAMA,Goodwater,1271.0,8,4,4
112,ALABAMA,Gordo,1580.0,8,4,4
113,ALABAMA,Gordon,328.0,1,1,0
114,ALABAMA,Grant,904.0,1,1,0
115,ALABAMA,Greensboro,2245.0,9,9,0
116,ALABAMA,Greenville,7280.0,33,30,3
117,ALABAMA,Grove Hill,1688.0,8,8,0
118,ALABAMA,Guin,2238.0,6,6,0
119,ALABAMA,Gulf Shores,13421.0,75,52,23
120,ALABAMA,Guntersville,8720.0,47,37,10
121,ALABAMA,Gurley,818.0,5,5,0
122,ALABAMA,Hackleburg,1227.0,2,2,0
123,ALABAMA,Haleyville,4077.0,16,11,5
124,ALABAMA,Hamilton,6621.0,16,14,2
125,ALABAMA,Hanceville,3571.0,24,15,9
126,ALABAMA,Harpersville,1757.0,6,6,0
127,ALABAMA,Hartford,2588.0,15,11,4
128,ALABAMA,Hartselle,14490.0,34,33,1
129,ALABAMA,Hayden,1359.0,3,3,0
130,ALABAMA,Hayneville,814.0,3,3,0
131,ALABAMA,Headland,4770.0,27,12,15
132,ALABAMA,Heflin,3400.0,12,11,1
133,ALABAMA,Helena,20756.0,36,30,6
134,ALABAMA,Henagar,2367.0,6,6,0
135,ALABAMA,Hillsboro,508.0,2,2,0
136,ALABAMA,Hokes Bluff,4237.0,9,7,2
137,ALABAMA,Hollywood,981.0,4,3,1
138,ALABAMA,Homewood,25179.0,104,77,27
139,ALABAMA,Hoover,86514.0,211,175,36
140,ALABAMA,Hueytown,15109.0,52,35,17
141,ALABAMA,Huntsville,205307.0,529,435,94
142,ALABAMA,Ider,737.0,7,4,3
143,ALABAMA,Irondale,13285.0,39,32,7
144,ALABAMA,Jackson,4523.0,31,24,7
145,ALABAMA,Jacksons Gap,823.0,1,1,0
146,ALABAMA,Jacksonville,12949.0,43,33,10
147,ALABAMA,Jasper,13177.0,23,3,20
148,ALABAMA,Jemison,2700.0,13,13,0
149,ALABAMA,Killen,958.0,4,4,0
150,ALABAMA,Kimberly,3688.0,7,7,0
151,ALABAMA,Kinsey,2302.0,2,2,0
152,ALABAMA,Kinston,553.0,1,1,0
153,ALABAMA,LaFayette,2858.0,12,11,1
154,ALABAMA,Lake View,2816.0,5,4,1
155,ALABAMA,Lanett,6014.0,31,28,3
156,ALABAMA,Leeds,12050.0,30,29,1
157,ALABAMA,Leesburg,1017.0,4,4,0
158,ALABAMA,Leighton,752.0,4,3,1
159,ALABAMA,Level Plains,1944.0,6,6,0
160,ALABAMA,Lexington,709.0,4,4,0
161,ALABAMA,Lincoln,7058.0,21,19,2
162,ALABAMA,Linden,1829.0,7,7,0
163,ALABAMA,Lineville,2203.0,10,6,4
164,ALABAMA,Lipscomb,2101.0,9,5,4
165,ALABAMA,Littleville,990.0,2,2,0
166,ALABAMA,Livingston,3106.0,9,6,3
167,ALABAMA,Louisville,452.0,1,1,0
168,ALABAMA,Loxley,3544.0,24,17,7
169,ALABAMA,Luverne,2694.0,14,13,1
170,ALABAMA,Lynn,630.0,1,1,0
171,ALABAMA,Madison,53663.0,107,79,28
172,ALABAMA,Maplesville,694.0,6,6,0
173,ALABAMA,Margaret,5388.0,8,6,2
174,ALABAMA,Marion,2993.0,7,5,2
175,ALABAMA,McIntosh,207.0,9,9,0
176,ALABAMA,Mentone,333.0,2,2,0
177,ALABAMA,Midfield,4918.0,17,12,5
178,ALABAMA,Midland City,2396.0,9,5,4
179,ALABAMA,Millbrook,16226.0,48,34,14
180,ALABAMA,Millport,963.0,2,2,0
181,ALABAMA,Mobile,242894.0,601,459,142
182,ALABAMA,Monroeville,5544.0,25,20,5
183,ALABAMA,Montevallo,7179.0,21,17,4
184,ALABAMA,Montgomery,195361.0,483,438,45
185,ALABAMA,Moody,13458.0,28,27,1
186,ALABAMA,Morris,2210.0,5,5,0
187,ALABAMA,Moulton,3177.0,11,11,0
188,ALABAMA,Moundville,2504.0,11,10,1
189,ALABAMA,Mountain Brook,20006.0,73,60,13
190,ALABAMA,Mount Vernon,1498.0,13,7,6
191,ALABAMA,Munford,1341.0,2,1,1
192,ALABAMA,Muscle Shoals,15051.0,48,38,10
193,ALABAMA,Napier Field,343.0,1,1,0
194,ALABAMA,New Brockton,1301.0,2,2,0
195,ALABAMA,New Hope,2939.0,5,5,0
196,ALABAMA,New Site,753.0,2,2,0
197,ALABAMA,Newton,1446.0,4,4,0
198,ALABAMA,North Courtland,620.0,1,1,0
199,ALABAMA,Northport,26309.0,68,51,17
200,ALABAMA,Notasulga,804.0,8,4,4
201,ALABAMA,Oakman,706.0,1,1,0
202,ALABAMA,Odenville,3907.0,14,14,0
203,ALABAMA,Ohatchee,1149.0,5,5,0
204,ALABAMA,Oneonta,6603.0,24,23,1
205,ALABAMA,Opelika,31644.0,115,92,23
206,ALABAMA,Opp,6279.0,26,19,7
207,ALABAMA,Orange Beach,6440.0,88,58,30
208,ALABAMA,Owens Crossroads,2316.0,4,4,0
209,ALABAMA,Oxford,21182.0,82,68,14
210,ALABAMA,Ozark,14065.0,32,25,7
211,ALABAMA,Parrish,923.0,2,2,0
212,ALABAMA,Pelham,24516.0,80,65,15
213,ALABAMA,Pell City,14461.0,40,37,3
214,ALABAMA,Phenix City,36744.0,98,77,21
215,ALABAMA,Phil Campbell,1067.0,5,1,4
216,ALABAMA,Pickensville,569.0,1,1,0
217,ALABAMA,Piedmont,4436.0,21,14,7
218,ALABAMA,Pine Hill,822.0,4,4,0
219,ALABAMA,Pleasant Grove,9528.0,20,15,5
220,ALABAMA,Powell,910.0,2,2,0
221,ALABAMA,Prattville,36716.0,97,92,5
222,ALABAMA,Priceville,4137.0,6,6,0
223,ALABAMA,Prichard,21170.0,58,38,20
224,ALABAMA,Ragland,1727.0,4,4,0
225,ALABAMA,Rainbow City,9602.0,38,25,13
226,ALABAMA,Rainsville,5168.0,18,12,6
227,ALABAMA,Ranburne,391.0,2,1,1
228,ALABAMA,Red Bay,3103.0,13,9,4
229,ALABAMA,Red Level,473.0,2,2,0
230,ALABAMA,Reform,1531.0,5,5,0
231,ALABAMA,Repton,252.0,2,1,1
232,ALABAMA,River Falls,528.0,2,2,0
233,ALABAMA,Riverside,2393.0,5,5,0
234,ALABAMA,Roanoke,5926.0,28,23,5
235,ALABAMA,Robertsdale,7187.0,28,17,11
236,ALABAMA,Rogersville,1296.0,5,5,0
237,ALABAMA,Russellville,9751.0,25,21,4
238,ALABAMA,Samson,1845.0,7,7,0
239,ALABAMA,Saraland,14764.0,59,48,11
240,ALABAMA,Sardis City,1782.0,3,3,0
241,ALABAMA,Satsuma,6214.0,15,12,3
242,ALABAMA,Scottsboro,14333.0,71,44,27
243,ALABAMA,Selma,16309.0,44,26,18
244,ALABAMA,Sheffield,8820.0,30,24,6
245,ALABAMA,Shorter,376.0,10,6,4
246,ALABAMA,Silverhill,1365.0,10,9,1
247,ALABAMA,Skyline,834.0,1,1,0
248,ALABAMA,Slocomb,1924.0,10,10,0
249,ALABAMA,Snead,837.0,6,6,0
250,ALABAMA,Somerville,783.0,2,2,0
251,ALABAMA,Southside,9108.0,16,13,3
252,ALABAMA,Spanish Fort,9765.0,31,27,4
253,ALABAMA,Steele,1099.0,3,3,0
254,ALABAMA,Stevenson,1886.0,7,4,3
255,ALABAMA,St. Florian,818.0,5,5,0
256,ALABAMA,Sulligent,1826.0,7,7,0
257,ALABAMA,Sumiton,2311.0,16,8,8
258,ALABAMA,Summerdale,1922.0,7,6,1
259,ALABAMA,Sylacauga,11859.0,36,34,2
260,ALABAMA,Sylvania,1863.0,3,3,0
261,ALABAMA,Talladega,15233.0,37,33,4
262,ALABAMA,Tallassee,4434.0,29,21,8
263,ALABAMA,Tarrant,6048.0,43,34,9
264,ALABAMA,Taylor,2449.0,4,3,1
265,ALABAMA,Thomaston,379.0,1,1,0
266,ALABAMA,Thomasville,3726.0,27,21,6
267,ALABAMA,Thorsby,2081.0,6,6,0
268,ALABAMA,Town Creek,1040.0,3,3,0
269,ALABAMA,Trafford,602.0,8,5,3
270,ALABAMA,Triana,1477.0,3,3,0
271,ALABAMA,Trinity,2477.0,8,8,0
272,ALABAMA,Troy,18822.0,51,40,11
273,ALABAMA,Trussville,23379.0,86,71,15
274,ALABAMA,Tuscaloosa,104151.0,344,273,71
275,ALABAMA,Tuscumbia,8449.0,28,21,7
276,ALABAMA,Tuskegee,7864.0,25,14,11
277,ALABAMA,Union Springs,3308.0,17,10,7
278,ALABAMA,Uniontown,2102.0,3,2,1
279,ALABAMA,Valley,9038.0,29,28,1
280,ALABAMA,Valley Head,562.0,2,2,0
281,ALABAMA,Vance,1841.0,6,6,0
282,ALABAMA,Vernon,1828.0,9,9,0
283,ALABAMA,Vestavia Hills,34369.0,108,104,4
284,ALABAMA,Wadley,706.0,4,4,0
285,ALABAMA,Warrior,3192.0,23,14,9
286,ALABAMA,Weaver,3027.0,11,8,3
287,ALABAMA,Wedowee,800.0,10,9,1
288,ALABAMA,West Blocton,1222.0,1,1,0
289,ALABAMA,Wetumpka,8617.0,32,29,3
290,ALABAMA,White Hall,726.0,3,1,2
291,ALABAMA,Winfield,4544.0,13,12,1
292,ALABAMA,Woodstock,1653.0,5,5,0
293,ALABAMA,York,2188.0,6,5,1
294,ALASKA,Anchorage,286238.0,574,413,161
295,ALASKA,Bethel,6717.0,31,19,12
296,ALASKA,Bristol Bay Borough,769.0,10,4,6
297,ALASKA,Cordova,2162.0,8,4,4
298,ALASKA,Craig,1273.0,10,5,5
299,ALASKA,Dillingham,2324.0,17,7,10
300,ALASKA,Fairbanks,30598.0,41,36,5
301,ALASKA,Haines,2624.0,8,4,4
302,ALASKA,Homer,6143.0,21,11,10
303,ALASKA,Hoonah,801.0,7,4,3
304,ALASKA,Juneau,31874.0,86,48,38
305,ALASKA,Kenai,7970.0,25,16,9
306,ALASKA,Ketchikan,8198.0,35,23,12
307,ALASKA,Klawock,781.0,2,2,0
308,ALASKA,Kodiak,5776.0,39,16,23
309,ALASKA,Kotzebue,3264.0,17,15,2
310,ALASKA,Nome,3871.0,22,11,11
311,ALASKA,North Pole,2106.0,15,13,2
312,ALASKA,North Slope Borough,9310.0,75,43,32
313,ALASKA,Palmer,7972.0,23,14,9
314,ALASKA,Petersburg,3302.0,13,9,4
315,ALASKA,Sand Point,1100.0,5,4,1
316,ALASKA,Seldovia,280.0,1,1,0
317,ALASKA,Seward,2950.0,19,10,9
318,ALASKA,Sitka,8353.0,29,14,15
319,ALASKA,Skagway,1202.0,10,4,6
320,ALASKA,Soldotna,4855.0,17,14,3
321,ALASKA,St. Paul,486.0,6,2,4
322,ALASKA,Unalaska,4484.0,24,12,12
323,ALASKA,Valdez,3842.0,12,12,0
324,ALASKA,Wasilla,11485.0,28,25,3
325,ALASKA,Whittier,203.0,7,7,0
326,ALASKA,Wrangell,2522.0,12,6,6
327,ARIZONA,Apache Junction,44607.0,96,65,31
328,ARIZONA,Avondale,91009.0,184,130,54
329,ARIZONA,Benson,4868.0,22,14,8
330,ARIZONA,Bisbee,5111.0,16,10,6
331,ARIZONA,Buckeye,93218.0,147,108,39
332,ARIZONA,Bullhead City,41958.0,111,70,41
333,ARIZONA,Camp Verde,11299.0,36,21,15
334,ARIZONA,Casa Grande,62566.0,101,79,22
335,ARIZONA,Chandler,281162.0,476,328,148
336,ARIZONA,Chino Valley,13039.0,32,25,7
337,ARIZONA,Clarkdale,4577.0,11,10,1
338,ARIZONA,Clifton,3675.0,8,3,5
339,ARIZONA,Coolidge,13973.0,48,34,14
340,ARIZONA,Cottonwood,12935.0,58,33,25
341,ARIZONA,Douglas,16349.0,42,29,13
342,ARIZONA,Eagar,4960.0,7,5,2
343,ARIZONA,El Mirage,36476.0,69,52,17
344,ARIZONA,Eloy,17347.0,40,31,9
345,ARIZONA,Flagstaff,74778.0,169,105,64
346,ARIZONA,Florence,28254.0,38,28,10
347,ARIZONA,Fredonia,1266.0,4,4,0
348,ARIZONA,Gilbert,272941.0,420,291,129
349,ARIZONA,Glendale,252981.0,540,409,131
350,ARIZONA,Globe,7368.0,23,19,4
351,ARIZONA,Goodyear,97081.0,168,118,50
352,ARIZONA,Hayden,979.0,5,5,0
353,ARIZONA,Holbrook,5094.0,11,10,1
354,ARIZONA,Huachuca City,1722.0,7,4,3
355,ARIZONA,Jerome,460.0,4,4,0
356,ARIZONA,Kearny,2233.0,12,7,5
357,ARIZONA,Kingman,32210.0,66,48,18
358,ARIZONA,Lake Havasu City,57735.0,105,72,33
359,ARIZONA,Mammoth,1740.0,4,3,1
360,ARIZONA,Marana,53347.0,127,97,30
361,ARIZONA,Maricopa,55768.0,81,69,12
362,ARIZONA,Mesa,513713.0,1278,846,432
363,ARIZONA,Miami,1787.0,10,6,4
364,ARIZONA,Nogales,20039.0,60,40,20
365,ARIZONA,Oro Valley,47282.0,126,99,27
366,ARIZONA,Page,7530.0,30,16,14
367,ARIZONA,Paradise Valley,12895.0,48,34,14
368,ARIZONA,Parker,3304.0,14,11,3
369,ARIZONA,Payson,16011.0,48,27,21
370,ARIZONA,Peoria,194566.0,286,189,97
371,ARIZONA,Phoenix,1638290.0,3772,2795,977
372,ARIZONA,Pima,2611.0,6,6,0
373,ARIZONA,Pinetop-Lakeside,4540.0,16,12,4
374,ARIZONA,Prescott,45391.0,89,74,15
375,ARIZONA,Prescott Valley,48921.0,105,74,31
376,ARIZONA,Quartzsite,3827.0,12,11,1
377,ARIZONA,Safford,9994.0,27,24,3
378,ARIZONA,Sahuarita,33005.0,63,51,12
379,ARIZONA,Scottsdale,245886.0,613,375,238
380,ARIZONA,Sedona,10358.0,43,24,19
381,ARIZONA,Show Low,11670.0,52,30,22
382,ARIZONA,Sierra Vista,43814.0,74,58,16
383,ARIZONA,Snowflake-Taylor,10559.0,15,12,3
384,ARIZONA,Somerton,16976.0,22,14,8
385,ARIZONA,South Tucson,5752.0,17,16,1
386,ARIZONA,Springerville,1987.0,6,4,2
387,ARIZONA,St. Johns,3529.0,11,8,3
388,ARIZONA,Superior,3270.0,15,14,1
389,ARIZONA,Surprise,145832.0,206,143,63
390,ARIZONA,Tempe,183973.0,460,326,134
391,ARIZONA,Thatcher,5310.0,13,12,1
392,ARIZONA,Tombstone,1302.0,11,8,3
393,ARIZONA,Tucson,556297.0,1059,820,239
394,ARIZONA,Wellton,3187.0,7,6,1
395,ARIZONA,Wickenburg,7614.0,26,19,7
396,ARIZONA,Willcox,3485.0,17,9,8
397,ARIZONA,Williams,3349.0,23,13,10
398,ARIZONA,Winslow,9655.0,40,18,22
399,ARIZONA,Yuma,100710.0,242,132,110
400,ARKANSAS,Alexander,3701.0,10,10,0
401,ARKANSAS,Alma,5925.0,18,13,5
402,ARKANSAS,Altus,727.0,1,1,0
403,ARKANSAS,Amity,670.0,1,1,0
404,ARKANSAS,Arkadelphia,10624.0,29,23,6
405,ARKANSAS,Ashdown,4326.0,14,12,2
406,ARKANSAS,Ash Flat,1101.0,6,6,0
407,ARKANSAS,Atkins,3045.0,9,8,1
408,ARKANSAS,Augusta,1900.0,5,5,0
409,ARKANSAS,Austin,4874.0,4,4,0
410,ARKANSAS,Bald Knob,2864.0,10,8,2
411,ARKANSAS,Barling,5103.0,10,10,0
412,ARKANSAS,Batesville,10880.0,25,24,1
413,ARKANSAS,Bay,1817.0,5,5,0
414,ARKANSAS,Bearden,839.0,2,2,0
415,ARKANSAS,Beebe,8299.0,23,18,5
416,ARKANSAS,Bella Vista,29723.0,52,36,16
417,ARKANSAS,Benton,37911.0,80,71,9
418,ARKANSAS,Bentonville,60329.0,115,82,33
419,ARKANSAS,Berryville,5537.0,14,13,1
420,ARKANSAS,Blytheville,13003.0,54,33,21
421,ARKANSAS,Bono,2637.0,4,4,0
422,ARKANSAS,Booneville,3744.0,13,9,4
423,ARKANSAS,Bradford,735.0,3,3,0
424,ARKANSAS,Brinkley,2480.0,15,7,8
425,ARKANSAS,Brookland,4136.0,6,6,0
426,ARKANSAS,Bryant,21902.0,58,47,11
427,ARKANSAS,Bull Shoals,1951.0,4,4,0
428,ARKANSAS,Cabot,26696.0,57,46,11
429,ARKANSAS,Caddo Valley,630.0,4,4,0
430,ARKANSAS,Camden,10499.0,34,16,18
431,ARKANSAS,Cammack Village,706.0,5,4,1
432,ARKANSAS,Caraway,1289.0,3,3,0
433,ARKANSAS,Carlisle,2147.0,8,6,2
434,ARKANSAS,Cave Springs,6386.0,11,11,0
435,ARKANSAS,Cedarville,1411.0,2,2,0
436,ARKANSAS,Centerton,18857.0,25,22,3
437,ARKANSAS,Charleston,2499.0,5,5,0
438,ARKANSAS,Cherokee Village,4650.0,7,6,1
439,ARKANSAS,Cherry Valley,565.0,1,1,0
440,ARKANSAS,Clarendon,1303.0,4,4,0
441,ARKANSAS,Clarksville,9775.0,22,19,3
442,ARKANSAS,Clinton,2492.0,8,7,1
443,ARKANSAS,Conway,69018.0,171,123,48
444,ARKANSAS,Corning,2982.0,7,4,3
445,ARKANSAS,Cotter,956.0,3,3,0
446,ARKANSAS,Crossett,4629.0,26,17,9
447,ARKANSAS,Damascus,383.0,1,1,0
448,ARKANSAS,Danville,2361.0,7,6,1
449,ARKANSAS,Dardanelle,4475.0,16,11,5
450,ARKANSAS,Decatur,1800.0,7,7,0
451,ARKANSAS,De Queen,6387.0,16,16,0
452,ARKANSAS,Dermott,2385.0,8,4,4
453,ARKANSAS,Des Arc,1553.0,6,6,0
454,ARKANSAS,DeWitt,2941.0,12,8,4
455,ARKANSAS,Diamond City,803.0,1,1,0
456,ARKANSAS,Diaz,1197.0,3,3,0
457,ARKANSAS,Dierks,1071.0,4,4,0
458,ARKANSAS,Dover,1451.0,5,5,0
459,ARKANSAS,Dumas,3897.0,18,10,8
460,ARKANSAS,Dyer,891.0,1,1,0
461,ARKANSAS,Earle,2142.0,3,3,0
462,ARKANSAS,El Dorado,17263.0,61,45,16
463,ARKANSAS,Elkins,3778.0,10,10,0
464,ARKANSAS,England,2643.0,12,8,4
465,ARKANSAS,Etowah,308.0,1,1,0
466,ARKANSAS,Eudora,1833.0,5,4,1
467,ARKANSAS,Eureka Springs,2085.0,18,14,4
468,ARKANSAS,Fairfield Bay,2164.0,17,7,10
469,ARKANSAS,Farmington,7748.0,19,18,1
470,ARKANSAS,Fayetteville,91309.0,168,123,45
471,ARKANSAS,Flippin,1313.0,7,7,0
472,ARKANSAS,Fordyce,3527.0,10,7,3
473,ARKANSAS,Forrest City,13496.0,28,23,5
474,ARKANSAS,Fort Smith,87912.0,184,138,46
475,ARKANSAS,Gassville,2183.0,4,4,0
476,ARKANSAS,Gentry,4323.0,11,9,2
477,ARKANSAS,Gillett,690.0,1,1,0
478,ARKANSAS,Glenwood,2092.0,4,4,0
479,ARKANSAS,Gosnell,3017.0,6,6,0
480,ARKANSAS,Gravette,3660.0,15,14,1
481,ARKANSAS,Greenbrier,5899.0,15,10,5
482,ARKANSAS,Green Forest,2955.0,15,12,3
483,ARKANSAS,Greenland,1408.0,4,4,0
484,ARKANSAS,Greenwood,9426.0,21,20,1
485,ARKANSAS,Greers Ferry,857.0,5,4,1
486,ARKANSAS,Gurdon,2050.0,6,4,2
487,ARKANSAS,Guy,796.0,2,2,0
488,ARKANSAS,Hackett,842.0,1,1,0
489,ARKANSAS,Hamburg,2514.0,7,6,1
490,ARKANSAS,Hampton,1230.0,4,3,1
491,ARKANSAS,Hardy,761.0,4,4,0
492,ARKANSAS,Harrisburg,2287.0,8,6,2
493,ARKANSAS,Harrison,13160.0,43,34,9
494,ARKANSAS,Haskell,4700.0,7,7,0
495,ARKANSAS,Hazen,1317.0,6,6,0
496,ARKANSAS,Heber Springs,6872.0,19,18,1
497,ARKANSAS,Helena-West Helena,9820.0,29,16,13
498,ARKANSAS,Higginson,749.0,1,1,0
499,ARKANSAS,Highfill,965.0,4,4,0
500,ARKANSAS,Highland,1111.0,4,4,0
501,ARKANSAS,Hope,9373.0,33,22,11
502,ARKANSAS,Hot Springs,39040.0,145,109,36
503,ARKANSAS,Hoxie,2559.0,4,4,0
504,ARKANSAS,Hughes,1178.0,2,2,0
505,ARKANSAS,Huntington,613.0,1,1,0
506,ARKANSAS,Huntsville,2617.0,10,8,2
507,ARKANSAS,Jacksonville,28356.0,72,59,13
508,ARKANSAS,Jericho,98.0,2,2,0
509,ARKANSAS,Johnson,3809.0,11,10,1
510,ARKANSAS,Jonesboro,81208.0,195,166,29
511,ARKANSAS,Judsonia,1989.0,4,3,1
512,ARKANSAS,Kensett,1611.0,5,4,1
513,ARKANSAS,Lake City,2810.0,4,4,0
514,ARKANSAS,Lakeview,723.0,2,2,0
515,ARKANSAS,Lake Village,2113.0,16,10,6
516,ARKANSAS,Lamar,1741.0,3,3,0
517,ARKANSAS,Lavaca,2453.0,3,3,0
518,ARKANSAS,Leachville,1816.0,5,4,1
519,ARKANSAS,Lead Hill,268.0,2,2,0
520,ARKANSAS,Lepanto,1781.0,8,4,4
521,ARKANSAS,Lewisville,1095.0,2,2,0
522,ARKANSAS,Lincoln,2492.0,8,8,0
523,ARKANSAS,Little Flock,2842.0,9,8,1
524,ARKANSAS,Little Rock,198260.0,659,534,125
525,ARKANSAS,Lonoke,4152.0,17,13,4
526,ARKANSAS,Lowell,10171.0,29,23,6
527,ARKANSAS,Luxora,991.0,1,1,0
528,ARKANSAS,Magnolia,11410.0,25,23,2
529,ARKANSAS,Malvern,10805.0,25,23,2
530,ARKANSAS,Mammoth Spring,938.0,2,2,0
531,ARKANSAS,Mansfield,1083.0,4,4,0
532,ARKANSAS,Marianna,3219.0,22,10,12
533,ARKANSAS,Marion,12266.0,35,30,5
534,ARKANSAS,Marked Tree,2366.0,11,6,5
535,ARKANSAS,Marmaduke,1262.0,3,3,0
536,ARKANSAS,Marshall,1321.0,3,3,0
537,ARKANSAS,Marvell,860.0,7,4,3
538,ARKANSAS,Maumelle,18343.0,42,32,10
539,ARKANSAS,Mayflower,2437.0,10,9,1
540,ARKANSAS,McCrory,1473.0,5,5,0
541,ARKANSAS,McGehee,3545.0,20,8,12
542,ARKANSAS,McRae,670.0,4,1,3
543,ARKANSAS,Mena,5377.0,14,13,1
544,ARKANSAS,Menifee,323.0,1,1,0
545,ARKANSAS,Mineral Springs,1133.0,3,3,0
546,ARKANSAS,Monette,1639.0,3,3,0
547,ARKANSAS,Monticello,9145.0,29,21,8
548,ARKANSAS,Morrilton,6672.0,28,25,3
549,ARKANSAS,Mountainburg,611.0,1,1,0
550,ARKANSAS,Mountain Home,12657.0,41,33,8
551,ARKANSAS,Mountain View,2917.0,11,10,1
552,ARKANSAS,Mulberry,1699.0,4,4,0
553,ARKANSAS,Murfreesboro,1565.0,3,3,0
554,ARKANSAS,Nashville,4263.0,17,16,1
555,ARKANSAS,Newport,7335.0,25,18,7
556,ARKANSAS,North Little Rock,66677.0,200,170,30
557,ARKANSAS,Ola,1190.0,4,3,1
558,ARKANSAS,Osceola,6472.0,33,23,10
559,ARKANSAS,Ozark,3618.0,12,10,2
560,ARKANSAS,Paragould,29559.0,55,48,7
561,ARKANSAS,Paris,3352.0,13,8,5
562,ARKANSAS,Patterson,382.0,1,1,0
563,ARKANSAS,Pea Ridge,6652.0,14,13,1
564,ARKANSAS,Perryville,1438.0,5,5,0
565,ARKANSAS,Piggott,3464.0,8,8,0
566,ARKANSAS,Pine Bluff,39670.0,124,102,22
567,ARKANSAS,Plumerville,773.0,1,1,0
568,ARKANSAS,Pocahontas,6781.0,18,17,1
569,ARKANSAS,Pottsville,3423.0,8,6,2
570,ARKANSAS,Prairie Grove,7380.0,16,16,0
571,ARKANSAS,Prescott,2892.0,8,7,1
572,ARKANSAS,Quitman,705.0,4,4,0
573,ARKANSAS,Ravenden,443.0,1,1,0
574,ARKANSAS,Redfield,1513.0,7,6,1
575,ARKANSAS,Rogers,72122.0,158,114,44
576,ARKANSAS,Rose Bud,493.0,4,3,1
577,ARKANSAS,Russellville,29465.0,61,55,6
578,ARKANSAS,Salem,1657.0,5,4,1
579,ARKANSAS,Searcy,23604.0,71,53,18
580,ARKANSAS,Shannon Hills,4196.0,4,4,0
581,ARKANSAS,Sheridan,5075.0,29,15,14
582,ARKANSAS,Sherwood,31857.0,96,77,19
583,ARKANSAS,Siloam Springs,17877.0,54,39,15
584,ARKANSAS,Springdale,85234.0,201,143,58
585,ARKANSAS,Stamps,1446.0,4,3,1
586,ARKANSAS,Star City,1989.0,6,5,1
587,ARKANSAS,St. Charles,210.0,3,1,2
588,ARKANSAS,Stuttgart,8312.0,37,20,17
589,ARKANSAS,Sulphur Springs,532.0,13,13,0
590,ARKANSAS,Swifton,726.0,1,1,0
591,ARKANSAS,Texarkana,29516.0,82,72,10
592,ARKANSAS,Trumann,6869.0,26,18,8
593,ARKANSAS,Tuckerman,1670.0,5,5,0
594,ARKANSAS,Turrell,543.0,1,1,0
595,ARKANSAS,Tyronza,707.0,2,1,1
596,ARKANSAS,Van Buren,23912.0,63,53,10
597,ARKANSAS,Vilonia,4824.0,9,9,0
598,ARKANSAS,Waldron,3303.0,10,9,1
599,ARKANSAS,Walnut Ridge,5137.0,9,9,0
600,ARKANSAS,Ward,5649.0,13,12,1
601,ARKANSAS,Warren,5458.0,22,14,8
602,ARKANSAS,Weiner,657.0,1,1,0
603,ARKANSAS,West Fork,2649.0,7,6,1
604,ARKANSAS,West Memphis,23959.0,86,69,17
605,ARKANSAS,White Hall,4830.0,20,18,2
606,ARKANSAS,Wilson,793.0,1,1,0
607,ARKANSAS,Wynne,7546.0,21,19,2
608,CALIFORNIA,Alameda,79356.0,97,67,30
609,CALIFORNIA,Albany,20179.0,34,25,9
610,CALIFORNIA,Alhambra,83278.0,121,81,40
611,CALIFORNIA,Alturas,2514.0,9,8,1
612,CALIFORNIA,Anaheim,355301.0,550,390,160
613,CALIFORNIA,Anderson,10626.0,25,19,6
614,CALIFORNIA,Angels Camp,3981.0,8,7,1
615,CALIFORNIA,Antioch,112499.0,155,112,43
616,CALIFORNIA,Arcadia,56331.0,88,62,26
617,CALIFORNIA,Arcata,18081.0,33,20,13
618,CALIFORNIA,Arroyo Grande,17874.0,28,25,3
619,CALIFORNIA,Arvin,22011.0,27,20,7
620,CALIFORNIA,Atascadero,30444.0,40,27,13
621,CALIFORNIA,Atherton,7019.0,30,22,8
622,CALIFORNIA,Atwater,30470.0,35,25,10
623,CALIFORNIA,Auburn,14294.0,28,20,8
624,CALIFORNIA,Avenal,13194.0,20,18,2
625,CALIFORNIA,Azusa,49518.0,76,50,26
626,CALIFORNIA,Bakersfield,389632.0,636,422,214
627,CALIFORNIA,Baldwin Park,74389.0,79,56,23
628,CALIFORNIA,Banning,30543.0,49,32,17
629,CALIFORNIA,Barstow,23660.0,54,37,17
630,CALIFORNIA,Bear Valley,120.0,6,5,1
631,CALIFORNIA,Beaumont,53116.0,63,48,15
632,CALIFORNIA,Bell,34662.0,39,27,12
633,CALIFORNIA,Bell Gardens,40846.0,67,47,20
634,CALIFORNIA,Belmont,26595.0,41,30,11
635,CALIFORNIA,Belvedere,2102.0,6,6,0
636,CALIFORNIA,Benicia,28083.0,48,29,19
637,CALIFORNIA,Berkeley,123754.0,239,149,90
638,CALIFORNIA,Beverly Hills,32911.0,211,125,86
639,CALIFORNIA,Bishop,3769.0,20,12,8
640,CALIFORNIA,Blythe,19588.0,28,19,9
641,CALIFORNIA,Brawley,26114.0,39,26,13
642,CALIFORNIA,Brea,45023.0,89,60,29
643,CALIFORNIA,Brentwood,66507.0,95,64,31
644,CALIFORNIA,Brisbane,4607.0,19,14,5
645,CALIFORNIA,Broadmoor,4148.0,18,17,1
646,CALIFORNIA,Buena Park,81342.0,121,83,38
647,CALIFORNIA,Burbank,101698.0,230,152,78
648,CALIFORNIA,Burlingame,29630.0,57,37,20
649,CALIFORNIA,Calexico,39637.0,38,22,16
650,CALIFORNIA,California City,13958.0,24,14,10
651,CALIFORNIA,Calipatria,6704.0,4,4,0
652,CALIFORNIA,Calistoga,5298.0,17,11,6
653,CALIFORNIA,Campbell,42608.0,69,44,25
654,CALIFORNIA,Capitola,9963.0,27,21,6
655,CALIFORNIA,Carlsbad,116633.0,160,123,37
656,CALIFORNIA,Carmel,3750.0,20,13,7
657,CALIFORNIA,Cathedral City,56122.0,64,46,18
658,CALIFORNIA,Central Marin,34691.0,56,42,14
659,CALIFORNIA,Ceres,48879.0,65,49,16
660,CALIFORNIA,Chico,104403.0,140,95,45
661,CALIFORNIA,Chino,93786.0,167,114,53
662,CALIFORNIA,Chowchilla,18103.0,31,20,11
663,CALIFORNIA,Chula Vista,275978.0,253,241,12
664,CALIFORNIA,Citrus Heights,88155.0,120,74,46
665,CALIFORNIA,Claremont,35119.0,66,41,25
666,CALIFORNIA,Clayton,11588.0,12,10,2
667,CALIFORNIA,Clearlake,15171.0,35,22,13
668,CALIFORNIA,Cloverdale,8823.0,21,13,8
669,CALIFORNIA,Clovis,120037.0,164,101,63
670,CALIFORNIA,Coalinga,17524.0,24,15,9
671,CALIFORNIA,Colma,1717.0,21,16,5
672,CALIFORNIA,Colton,54911.0,77,50,27
673,CALIFORNIA,Colusa,6085.0,9,9,0
674,CALIFORNIA,Concord,129173.0,169,131,38
675,CALIFORNIA,Corcoran,21524.0,31,17,14
676,CALIFORNIA,Corning,7621.0,20,12,8
677,CALIFORNIA,Corona,172922.0,222,151,71
678,CALIFORNIA,Coronado,22545.0,65,45,20
679,CALIFORNIA,Costa Mesa,112592.0,210,134,76
680,CALIFORNIA,Cotati,7470.0,18,12,6
681,CALIFORNIA,Covina,47207.0,82,54,28
682,CALIFORNIA,Crescent City,6767.0,13,12,1
683,CALIFORNIA,Culver City,38437.0,144,106,38
684,CALIFORNIA,Cypress,49094.0,67,52,15
685,CALIFORNIA,Daly City,106323.0,116,92,24
686,CALIFORNIA,Davis,69132.0,55,55,0
687,CALIFORNIA,Delano,53035.0,65,46,19
688,CALIFORNIA,Del Rey Oaks,1647.0,10,10,0
689,CALIFORNIA,Desert Hot Springs,29861.0,36,26,10
690,CALIFORNIA,Dinuba,25621.0,43,33,10
691,CALIFORNIA,Dixon,20655.0,36,30,6
692,CALIFORNIA,Dos Palos,5301.0,15,10,5
693,CALIFORNIA,Downey,108950.0,159,112,47
694,CALIFORNIA,East Palo Alto,29145.0,45,35,10
695,CALIFORNIA,El Cajon,102665.0,170,118,52
696,CALIFORNIA,El Centro,43684.0,67,43,24
697,CALIFORNIA,El Cerrito,25585.0,40,32,8
698,CALIFORNIA,Elk Grove,179887.0,230,139,91
699,CALIFORNIA,El Monte,112224.0,152,116,36
700,CALIFORNIA,El Segundo,16253.0,75,56,19
701,CALIFORNIA,Emeryville,12069.0,54,36,18
702,CALIFORNIA,Escalon,7626.0,13,12,1
703,CALIFORNIA,Escondido,150507.0,199,144,55
704,CALIFORNIA,Etna,703.0,4,4,0
705,CALIFORNIA,Eureka,26598.0,58,38,20
706,CALIFORNIA,Exeter,10430.0,19,17,2
707,CALIFORNIA,Fairfax,7572.0,16,11,5
708,CALIFORNIA,Fairfield,118846.0,179,113,66
709,CALIFORNIA,Farmersville,10830.0,19,18,1
710,CALIFORNIA,Ferndale,1361.0,5,5,0
711,CALIFORNIA,Firebaugh,7775.0,18,13,5
712,CALIFORNIA,Folsom,83871.0,101,75,26
713,CALIFORNIA,Fontana,218167.0,288,191,97
714,CALIFORNIA,Fort Bragg,7213.0,19,15,4
715,CALIFORNIA,Fortuna,12115.0,26,18,8
716,CALIFORNIA,Foster City,33131.0,52,37,15
717,CALIFORNIA,Fountain Valley,55408.0,78,58,20
718,CALIFORNIA,Fowler,6678.0,13,12,1
719,CALIFORNIA,Fremont,236681.0,289,189,100
720,CALIFORNIA,Fresno,533633.0,1070,769,301
721,CALIFORNIA,Fullerton,140399.0,169,114,55
722,CALIFORNIA,Galt,26849.0,39,28,11
723,CALIFORNIA,Gardena,58466.0,111,87,24
724,CALIFORNIA,Garden Grove,171397.0,237,172,65
725,CALIFORNIA,Gilroy,55438.0,87,59,28
726,CALIFORNIA,Glendale,198362.0,328,228,100
727,CALIFORNIA,Glendora,50543.0,81,50,31
728,CALIFORNIA,Gonzales,8245.0,13,10,3
729,CALIFORNIA,Grass Valley,12752.0,33,28,5
730,CALIFORNIA,Greenfield,17777.0,28,22,6
731,CALIFORNIA,Gridley,7481.0,17,12,5
732,CALIFORNIA,Grover Beach,13340.0,27,21,6
733,CALIFORNIA,Guadalupe,8255.0,17,15,2
734,CALIFORNIA,Gustine,5728.0,12,9,3
735,CALIFORNIA,Hanford,58751.0,85,59,26
736,CALIFORNIA,Hawthorne,83728.0,140,88,52
737,CALIFORNIA,Hayward,159368.0,282,170,112
738,CALIFORNIA,Healdsburg,11992.0,23,15,8
739,CALIFORNIA,Hemet,85792.0,99,70,29
740,CALIFORNIA,Hercules,26439.0,28,25,3
741,CALIFORNIA,Hermosa Beach,18734.0,65,38,27
742,CALIFORNIA,Hillsborough,11602.0,35,27,8
743,CALIFORNIA,Hollister,42505.0,40,31,9
744,CALIFORNIA,Huntington Beach,198980.0,289,183,106
745,CALIFORNIA,Huntington Park,56576.0,79,51,28
746,CALIFORNIA,Huron,7141.0,9,7,2
747,CALIFORNIA,Imperial,20228.0,22,19,3
748,CALIFORNIA,Indio,93242.0,105,64,41
749,CALIFORNIA,Inglewood,106967.0,233,180,53
750,CALIFORNIA,Ione,8397.0,8,8,0
751,CALIFORNIA,Irvine,291769.0,309,210,99
752,CALIFORNIA,Irwindale,1479.0,33,27,6
753,CALIFORNIA,Jackson,5006.0,11,9,2
754,CALIFORNIA,Kensington,5043.0,6,6,0
755,CALIFORNIA,Kerman,15523.0,26,22,4
756,CALIFORNIA,King City,14080.0,16,14,2
757,CALIFORNIA,Kingsburg,12484.0,25,21,4
758,CALIFORNIA,Laguna Beach,22680.0,88,52,36
759,CALIFORNIA,La Habra,62364.0,99,63,36
760,CALIFORNIA,Lakeport,4985.0,14,12,2
761,CALIFORNIA,Lake Shastina,2544.0,3,3,0
762,CALIFORNIA,La Mesa,59968.0,88,62,26
763,CALIFORNIA,La Palma,15402.0,26,20,6
764,CALIFORNIA,La Verne,32288.0,59,41,18
765,CALIFORNIA,Lemoore,26521.0,41,33,8
766,CALIFORNIA,Lincoln,49629.0,34,23,11
767,CALIFORNIA,Lindsay,13018.0,17,15,2
768,CALIFORNIA,Livermore,92677.0,128,90,38
769,CALIFORNIA,Livingston,15122.0,26,17,9
770,CALIFORNIA,Lodi,68811.0,100,70,30
771,CALIFORNIA,Lompoc,42251.0,67,40,27
772,CALIFORNIA,Long Beach,453931.0,1023,772,251
773,CALIFORNIA,Los Alamitos,11389.0,23,19,4
774,CALIFORNIA,Los Altos,30400.0,43,29,14
775,CALIFORNIA,Los Angeles,3988183.0,12166,9474,2692
776,CALIFORNIA,Los Banos,41041.0,70,44,26
777,CALIFORNIA,Los Gatos,30315.0,53,36,17
778,CALIFORNIA,Madera,67215.0,91,65,26
779,CALIFORNIA,Mammoth Lakes,8326.0,19,14,5
780,CALIFORNIA,Manhattan Beach,34215.0,93,60,33
781,CALIFORNIA,Manteca,86327.0,103,73,30
782,CALIFORNIA,Marina,22060.0,36,29,7
783,CALIFORNIA,Martinez,38221.0,45,32,13
784,CALIFORNIA,Marysville,12648.0,27,18,9
785,CALIFORNIA,McFarland,12465.0,23,17,6
786,CALIFORNIA,Mendota,12545.0,22,16,6
787,CALIFORNIA,Menifee,99883.0,94,67,27
788,CALIFORNIA,Menlo Park,35235.0,58,42,16
789,CALIFORNIA,Merced,89210.0,132,96,36
790,CALIFORNIA,Mill Valley,14363.0,26,21,5
791,CALIFORNIA,Milpitas,76858.0,115,84,31
792,CALIFORNIA,Modesto,216946.0,275,184,91
793,CALIFORNIA,Monrovia,37892.0,72,46,26
794,CALIFORNIA,Montclair,41006.0,66,46,20
795,CALIFORNIA,Montebello,61435.0,94,71,23
796,CALIFORNIA,Monterey,28561.0,65,48,17
797,CALIFORNIA,Monterey Park,59255.0,102,72,30
798,CALIFORNIA,Moraga,17063.0,12,10,2
799,CALIFORNIA,Morgan Hill,46317.0,62,40,22
800,CALIFORNIA,Morro Bay,10591.0,18,16,2
801,CALIFORNIA,Mountain View,80688.0,128,88,40
802,CALIFORNIA,Mount Shasta,3218.0,14,8,6
803,CALIFORNIA,Murrieta,117835.0,159,102,57
804,CALIFORNIA,Napa,77018.0,103,61,42
805,CALIFORNIA,National City,61171.0,122,84,38
806,CALIFORNIA,Nevada City,3128.0,8,7,1
807,CALIFORNIA,Newark,50470.0,76,50,26
808,CALIFORNIA,Newman,11847.0,15,13,2
809,CALIFORNIA,Newport Beach,86993.0,227,144,83
810,CALIFORNIA,Novato,53493.0,75,55,20
811,CALIFORNIA,Oakdale,23487.0,34,22,12
812,CALIFORNIA,Oakland,428406.0,987,682,305
813,CALIFORNIA,Oceanside,175335.0,288,200,88
814,CALIFORNIA,Ontario,185414.0,339,261,78
815,CALIFORNIA,Orange,138312.0,218,150,68
816,CALIFORNIA,Orange Cove,10155.0,13,12,1
817,CALIFORNIA,Orland,8138.0,13,11,2
818,CALIFORNIA,Oroville,20405.0,34,21,13
819,CALIFORNIA,Oxnard,208911.0,317,227,90
820,CALIFORNIA,Pacifica,38077.0,33,31,2
821,CALIFORNIA,Pacific Grove,15322.0,31,19,12
822,CALIFORNIA,Palm Springs,49367.0,146,93,53
823,CALIFORNIA,Palo Alto,67266.0,114,70,44
824,CALIFORNIA,Palos Verdes Estates,13044.0,26,16,10
825,CALIFORNIA,Paradise,3986.0,24,17,7
826,CALIFORNIA,Parlier,15979.0,18,14,4
827,CALIFORNIA,Pasadena,141402.0,325,221,104
828,CALIFORNIA,Paso Robles,31700.0,50,33,17
829,CALIFORNIA,Petaluma,60898.0,101,65,36
830,CALIFORNIA,Piedmont,11400.0,30,20,10
831,CALIFORNIA,Pinole,19293.0,42,24,18
832,CALIFORNIA,Pismo Beach,7985.0,31,21,10
833,CALIFORNIA,Pittsburg,73607.0,102,81,21
834,CALIFORNIA,Placentia,51579.0,57,45,12
835,CALIFORNIA,Placerville,11140.0,26,18,8
836,CALIFORNIA,Pleasant Hill,34949.0,58,43,15
837,CALIFORNIA,Pleasanton,81313.0,112,78,34
838,CALIFORNIA,Pomona,149206.0,268,146,122
839,CALIFORNIA,Porterville,59022.0,94,64,30
840,CALIFORNIA,Port Hueneme,21748.0,31,20,11
841,CALIFORNIA,Red Bluff,14126.0,39,25,14
842,CALIFORNIA,Redding,92714.0,147,101,46
843,CALIFORNIA,Redlands,72623.0,110,76,34
844,CALIFORNIA,Redondo Beach,65401.0,139,88,51
845,CALIFORNIA,Redwood City,85250.0,115,83,32
846,CALIFORNIA,Reedley,25879.0,44,31,13
847,CALIFORNIA,Rialto,104600.0,146,111,35
848,CALIFORNIA,Richmond,110698.0,180,130,50
849,CALIFORNIA,Ridgecrest,29282.0,46,28,18
850,CALIFORNIA,Rio Dell,3446.0,6,5,1
851,CALIFORNIA,Rio Vista,10285.0,14,12,2
852,CALIFORNIA,Ripon,17028.0,33,24,9
853,CALIFORNIA,Riverside,333437.0,520,363,157
854,CALIFORNIA,Rocklin,71575.0,85,60,25
855,CALIFORNIA,Rohnert Park,43167.0,94,70,24
856,CALIFORNIA,Roseville,147468.0,197,135,62
857,CALIFORNIA,Ross,2485.0,8,8,0
858,CALIFORNIA,Sacramento,517637.0,997,716,281
859,CALIFORNIA,Salinas,155283.0,181,142,39
860,CALIFORNIA,San Bernardino,218205.0,345,245,100
861,CALIFORNIA,San Bruno,44336.0,55,42,13
862,CALIFORNIA,Sand City,438.0,11,10,1
863,CALIFORNIA,San Diego,1434673.0,2394,1877,517
864,CALIFORNIA,San Fernando,24369.0,41,28,13
865,CALIFORNIA,San Francisco,865393.0,2857,2129,728
866,CALIFORNIA,San Gabriel,39454.0,65,51,14
867,CALIFORNIA,Sanger,26881.0,42,36,6
868,CALIFORNIA,San Jose,1019772.0,1624,1161,463
869,CALIFORNIA,San Leandro,89580.0,116,76,40
870,CALIFORNIA,San Luis Obispo,47837.0,86,57,29
871,CALIFORNIA,San Marino,12755.0,36,26,10
872,CALIFORNIA,San Mateo,102930.0,152,108,44
873,CALIFORNIA,San Pablo,30914.0,79,55,24
874,CALIFORNIA,San Rafael,58606.0,83,63,20
875,CALIFORNIA,San Ramon,84064.0,83,66,17
876,CALIFORNIA,Santa Ana,331934.0,588,361,227
877,CALIFORNIA,Santa Barbara,90428.0,181,121,60
878,CALIFORNIA,Santa Clara,132572.0,198,140,58
879,CALIFORNIA,Santa Cruz,64704.0,110,75,35
880,CALIFORNIA,Santa Maria,106495.0,164,120,44
881,CALIFORNIA,Santa Monica,90050.0,358,206,152
882,CALIFORNIA,Santa Paula,30297.0,41,30,11
883,CALIFORNIA,Santa Rosa,174562.0,240,164,76
884,CALIFORNIA,Sausalito,7107.0,25,19,6
885,CALIFORNIA,Scotts Valley,12038.0,26,17,9
886,CALIFORNIA,Seal Beach,23859.0,53,39,14
887,CALIFORNIA,Seaside,34211.0,39,28,11
888,CALIFORNIA,Sebastopol,7605.0,19,13,6
889,CALIFORNIA,Selma,24473.0,45,35,10
890,CALIFORNIA,Shafter,21136.0,43,30,13
891,CALIFORNIA,Sierra Madre,10592.0,21,16,5
892,CALIFORNIA,Signal Hill,11306.0,35,29,6
893,CALIFORNIA,Simi Valley,125243.0,173,119,54
894,CALIFORNIA,Soledad,25175.0,24,19,5
895,CALIFORNIA,Sonora,4828.0,19,13,6
896,CALIFORNIA,South Gate,93012.0,118,78,40
897,CALIFORNIA,South Lake Tahoe,22995.0,57,38,19
898,CALIFORNIA,South Pasadena,24935.0,49,33,16
899,CALIFORNIA,South San Francisco,66855.0,114,84,30
900,CALIFORNIA,Stallion Springs,2472.0,5,5,0
901,CALIFORNIA,St. Helena,5975.0,17,11,6
902,CALIFORNIA,Stockton,314764.0,615,432,183
903,CALIFORNIA,Suisun City,29425.0,33,22,11
904,CALIFORNIA,Sunnyvale,152893.0,282,205,77
905,CALIFORNIA,Susanville,14137.0,18,15,3
906,CALIFORNIA,Sutter Creek,2706.0,4,4,0
907,CALIFORNIA,Taft,8418.0,20,11,9
908,CALIFORNIA,Tehachapi,12596.0,28,19,9
909,CALIFORNIA,Tiburon,9099.0,17,13,4
910,CALIFORNIA,Torrance,141185.0,345,208,137
911,CALIFORNIA,Tracy,96252.0,146,93,53
912,CALIFORNIA,Truckee,17066.0,35,25,10
913,CALIFORNIA,Tulare,67583.0,106,73,33
914,CALIFORNIA,Tulelake,950.0,3,3,0
915,CALIFORNIA,Turlock,73507.0,113,77,36
916,CALIFORNIA,Tustin,80277.0,161,95,66
917,CALIFORNIA,Ukiah,15870.0,41,26,15
918,CALIFORNIA,Union City,75009.0,88,70,18
919,CALIFORNIA,Upland,78260.0,94,65,29
920,CALIFORNIA,Vacaville,102258.0,167,104,63
921,CALIFORNIA,Vallejo,121221.0,143,98,45
922,CALIFORNIA,Ventura,107118.0,178,138,40
923,CALIFORNIA,Vernon,318.0,55,41,14
924,CALIFORNIA,Visalia,136077.0,214,147,67
925,CALIFORNIA,Walnut Creek,70519.0,111,76,35
926,CALIFORNIA,Watsonville,51720.0,90,71,19
927,CALIFORNIA,Weed,2640.0,12,6,6
928,CALIFORNIA,West Covina,103417.0,134,87,47
929,CALIFORNIA,Westminster,89758.0,121,78,43
930,CALIFORNIA,Westmorland,2231.0,3,3,0
931,CALIFORNIA,West Sacramento,54187.0,99,71,28
932,CALIFORNIA,Wheatland,3682.0,9,8,1
933,CALIFORNIA,Whittier,82987.0,174,124,50
934,CALIFORNIA,Williams,5430.0,13,11,2
935,CALIFORNIA,Willits,4822.0,13,10,3
936,CALIFORNIA,Winters,7550.0,10,8,2
937,CALIFORNIA,Woodlake,8001.0,13,12,1
938,CALIFORNIA,Woodland,60958.0,82,67,15
939,CALIFORNIA,Yreka,7475.0,20,12,8
940,CALIFORNIA,Yuba City,66528.0,85,60,25
941,COLORADO,Alamosa,9414.0,30,25,5
942,COLORADO,Arvada,123548.0,213,161,52
943,COLORADO,Aspen,7750.0,35,26,9
944,COLORADO,Ault,2197.0,7,6,1
945,COLORADO,Aurora,393897.0,877,689,188
946,COLORADO,Avon,7012.0,19,15,4
947,COLORADO,Basalt,4226.0,12,11,1
948,COLORADO,Bayfield,2614.0,9,8,1
949,COLORADO,Black Hawk,132.0,29,21,8
950,COLORADO,Blue River,936.0,5,3,2
951,COLORADO,Boulder,108698.0,241,160,81
952,COLORADO,Breckenridge,4996.0,24,20,4
953,COLORADO,Brighton,41535.0,106,77,29
954,COLORADO,Broomfield,73077.0,226,120,106
955,COLORADO,Brush,5434.0,14,9,5
956,COLORADO,Buena Vista,3175.0,11,9,2
957,COLORADO,Burlington,3038.0,7,5,2
958,COLORADO,Calhan,831.0,5,4,1
959,COLORADO,Canon City,16552.0,41,33,8
960,COLORADO,Carbondale,6761.0,14,10,4
961,COLORADO,Castle Rock,73221.0,111,80,31
962,COLORADO,Cedaredge,2320.0,7,6,1
963,COLORADO,Centennial,111199.0,191,138,53
964,COLORADO,Center,2399.0,21,7,14
965,COLORADO,Cherry Hills Village,6685.0,28,24,4
966,COLORADO,Collbran,731.0,2,2,0
967,COLORADO,Colorado Springs,488747.0,1055,766,289
968,COLORADO,Columbine Valley,1537.0,5,5,0
969,COLORADO,Commerce City,60845.0,139,111,28
970,COLORADO,Cortez,8760.0,49,26,23
971,COLORADO,Craig,8905.0,24,16,8
972,COLORADO,Crested Butte,1703.0,9,8,1
973,COLORADO,Cripple Creek,1270.0,15,8,7
974,COLORADO,Dacono,6877.0,16,12,4
975,COLORADO,De Beque,551.0,5,5,0
976,COLORADO,Del Norte,1528.0,4,3,1
977,COLORADO,Delta,9047.0,24,18,6
978,COLORADO,Denver,740209.0,1784,1447,337
979,COLORADO,Dillon,973.0,12,11,1
980,COLORADO,Dinosaur,334.0,3,3,0
981,COLORADO,Durango,19995.0,66,52,14
982,COLORADO,Eagle,6954.0,12,11,1
983,COLORADO,Eaton,6191.0,13,9,4
984,COLORADO,Edgewater,5415.0,22,18,4
985,COLORADO,Elizabeth,1928.0,8,7,1
986,COLORADO,Empire,304.0,5,3,2
987,COLORADO,Englewood,35630.0,111,74,37
988,COLORADO,Erie,31873.0,47,40,7
989,COLORADO,Estes Park,6617.0,34,21,13
990,COLORADO,Evans,23698.0,36,31,5
991,COLORADO,Fairplay,814.0,3,3,0
992,COLORADO,Federal Heights,13828.0,40,23,17
993,COLORADO,Firestone,15932.0,33,30,3
994,COLORADO,Florence,3993.0,14,12,2
995,COLORADO,Fort Collins,170744.0,313,214,99
996,COLORADO,Fort Lupton,8800.0,25,19,6
997,COLORADO,Fort Morgan,11234.0,32,27,5
998,COLORADO,Fountain,31557.0,65,57,8
999,COLORADO,Fowler,1145.0,4,3,1
1000,COLORADO,Fraser/Winter Park,2478.0,12,10,2
1001,COLORADO,Frederick,11844.0,29,26,3
1002,COLORADO,Frisco,2892.0,13,11,2
1003,COLORADO,Fruita,14465.0,22,18,4
1004,COLORADO,Garden City,282.0,4,4,0
1005,COLORADO,Georgetown,1109.0,2,2,0
1006,COLORADO,Glendale,5192.0,41,28,13
1007,COLORADO,Glenwood Springs,10297.0,24,20,4
1008,COLORADO,Golden,20498.0,65,50,15
1009,COLORADO,Granada,508.0,2,1,1
1010,COLORADO,Granby,2209.0,12,9,3
1011,COLORADO,Grand Junction,63928.0,203,116,87
1012,COLORADO,Greeley,110660.0,208,149,59
1013,COLORADO,Green Mountain Falls,737.0,2,2,0
1014,COLORADO,Greenwood Village,15012.0,83,62,21
1015,COLORADO,Gunnison,6950.0,20,15,5
1016,COLORADO,Haxtun,936.0,1,1,0
1017,COLORADO,Hayden,1995.0,7,6,1
1018,COLORADO,Holyoke,2230.0,2,2,0
1019,COLORADO,Hotchkiss,929.0,5,4,1
1020,COLORADO,Hudson,2812.0,12,10,2
1021,COLORADO,Hugo,787.0,2,2,0
1022,COLORADO,Idaho Springs,1871.0,10,7,3
1023,COLORADO,Ignacio,974.0,7,7,0
1024,COLORADO,Johnstown,14413.0,27,24,3
1025,COLORADO,Kersey,1833.0,5,4,1
1026,COLORADO,Kremmling,1532.0,4,3,1
1027,COLORADO,Lafayette,29027.0,46,34,12
1028,COLORADO,La Junta,6831.0,19,13,6
1029,COLORADO,Lakeside,8.0,6,5,1
1030,COLORADO,Lakewood,158977.0,397,280,117
1031,COLORADO,Lamar,7612.0,21,15,6
1032,COLORADO,La Salle,2524.0,8,8,0
1033,COLORADO,La Veta,810.0,1,1,0
1034,COLORADO,Leadville,2796.0,7,2,5
1035,COLORADO,Limon,1951.0,4,4,0
1036,COLORADO,Littleton,46466.0,104,74,30
1037,COLORADO,Lochbuie,8301.0,13,10,3
1038,COLORADO,Log Lane Village,851.0,3,3,0
1039,COLORADO,Lone Tree,14007.0,62,50,12
1040,COLORADO,Longmont,99714.0,220,149,71
1041,COLORADO,Louisville,19127.0,35,28,7
1042,COLORADO,Loveland,85349.0,158,105,53
1043,COLORADO,Mancos,1404.0,5,5,0
1044,COLORADO,Manitou Springs,5509.0,15,14,1
1045,COLORADO,Manzanola,408.0,1,1,0
1046,COLORADO,Mead,5190.0,10,8,2
1047,COLORADO,Meeker,2305.0,7,6,1
1048,COLORADO,Milliken,9074.0,15,12,3
1049,COLORADO,Monte Vista,4030.0,17,14,3
1050,COLORADO,Montrose,19984.0,60,43,17
1051,COLORADO,Monument,8397.0,23,20,3
1052,COLORADO,Morrison,431.0,2,1,1
1053,COLORADO,Mountain View,553.0,10,9,1
1054,COLORADO,Mountain Village,1486.0,10,7,3
1055,COLORADO,Mount Crested Butte,901.0,9,8,1
1056,COLORADO,Nederland,1569.0,5,5,0
1057,COLORADO,New Castle,5012.0,12,10,2
1058,COLORADO,Northglenn,39162.0,82,64,18
1059,COLORADO,Nunn,506.0,2,2,0
1060,COLORADO,Oak Creek,966.0,3,3,0
1061,COLORADO,Olathe,1820.0,7,5,2
1062,COLORADO,Ouray,1050.0,5,5,0
1063,COLORADO,Pagosa Springs,2178.0,8,7,1
1064,COLORADO,Palisade,2812.0,11,9,2
1065,COLORADO,Palmer Lake,3092.0,2,2,0
1066,COLORADO,Paonia,1476.0,3,2,1
1067,COLORADO,Parachute,1118.0,6,5,1
1068,COLORADO,Parker,60178.0,109,68,41
1069,COLORADO,Platteville,4239.0,10,9,1
1070,COLORADO,Pueblo,113371.0,252,202,50
1071,COLORADO,Rangely,2295.0,11,5,6
1072,COLORADO,Ridgway,1055.0,3,3,0
1073,COLORADO,Rifle,9819.0,22,17,5
1074,COLORADO,Rocky Ford,3790.0,13,6,7
1075,COLORADO,Salida,5735.0,23,19,4
1076,COLORADO,Sanford,901.0,1,1,0
1077,COLORADO,Severance,8343.0,11,8,3
1078,COLORADO,Sheridan,6070.0,35,33,2
1079,COLORADO,Silt,3129.0,8,6,2
1080,COLORADO,Silverthorne,5019.0,21,18,3
1081,COLORADO,Simla,698.0,2,2,0
1082,COLORADO,Snowmass Village,2754.0,12,9,3
1083,COLORADO,South Fork,422.0,2,2,0
1084,COLORADO,Springfield,1355.0,4,3,1
1085,COLORADO,Steamboat Springs,13282.0,33,19,14
1086,COLORADO,Sterling,14006.0,24,19,5
1087,COLORADO,Telluride,2436.0,14,10,4
1088,COLORADO,Thornton,151324.0,314,227,87
1089,COLORADO,Timnath,3801.0,15,13,2
1090,COLORADO,Trinidad,8045.0,37,21,16
1091,COLORADO,Vail,5507.0,57,28,29
1092,COLORADO,Westminster,115942.0,236,170,66
1093,COLORADO,Wheat Ridge,32027.0,96,79,17
1094,COLORADO,Wiggins,1184.0,2,2,0
1095,COLORADO,Windsor,28756.0,53,44,9
1096,COLORADO,Woodland Park,8257.0,30,20,10
1097,COLORADO,Wray,2352.0,7,6,1
1098,COLORADO,Yuma,3495.0,10,8,2
1099,CONNECTICUT,Ansonia,18452.0,48,38,10
1100,CONNECTICUT,Avon,18226.0,43,33,10
1101,CONNECTICUT,Berlin,20440.0,52,41,11
1102,CONNECTICUT,Bethel,20066.0,52,39,13
1103,CONNECTICUT,Bloomfield,21254.0,59,46,13
1104,CONNECTICUT,Branford,27707.0,62,51,11
1105,CONNECTICUT,Bridgeport,143394.0,378,330,48
1106,CONNECTICUT,Bristol,59659.0,141,117,24
1107,CONNECTICUT,Brookfield,16944.0,44,34,10
1108,CONNECTICUT,Canton,10223.0,26,16,10
1109,CONNECTICUT,Cheshire,28755.0,58,45,13
1110,CONNECTICUT,Clinton,12846.0,37,27,10
1111,CONNECTICUT,Coventry,12384.0,18,13,5
1112,CONNECTICUT,Cromwell,13750.0,37,27,10
1113,CONNECTICUT,Danbury,84631.0,146,141,5
1114,CONNECTICUT,Darien,21790.0,67,49,18
1115,CONNECTICUT,Derby,12197.0,36,34,2
1116,CONNECTICUT,East Hampton,12726.0,19,17,2
1117,CONNECTICUT,East Hartford,49470.0,156,118,38
1118,CONNECTICUT,East Haven,28377.0,76,62,14
1119,CONNECTICUT,East Lyme,18467.0,34,27,7
1120,CONNECTICUT,Easton,7462.0,19,14,5
1121,CONNECTICUT,East Windsor,11702.0,36,26,10
1122,CONNECTICUT,Enfield,43452.0,119,96,23
1123,CONNECTICUT,Fairfield,62473.0,129,106,23
1124,CONNECTICUT,Farmington,25510.0,59,45,14
1125,CONNECTICUT,Glastonbury,34424.0,72,54,18
1126,CONNECTICUT,Granby,11585.0,21,16,5
1127,CONNECTICUT,Greenwich,62917.0,172,146,26
1128,CONNECTICUT,Groton,8823.0,33,26,7
1129,CONNECTICUT,Groton Long Point,504.0,5,5,0
1130,CONNECTICUT,Groton Town,28753.0,73,58,15
1131,CONNECTICUT,Guilford,22009.0,45,38,7
1132,CONNECTICUT,Hamden,60165.0,116,90,26
1133,CONNECTICUT,Hartford,121160.0,419,395,24
1134,CONNECTICUT,Ledyard,14534.0,31,22,9
1135,CONNECTICUT,Madison,17890.0,41,29,12
1136,CONNECTICUT,Manchester,57274.0,143,107,36
1137,CONNECTICUT,Meriden,58799.0,128,116,12
1138,CONNECTICUT,Middlebury,7851.0,14,12,2
1139,CONNECTICUT,Middletown,45852.0,120,106,14
1140,CONNECTICUT,Milford,54984.0,121,110,11
1141,CONNECTICUT,Monroe,19311.0,54,43,11
1142,CONNECTICUT,Naugatuck,30810.0,86,68,18
1143,CONNECTICUT,New Britain,72093.0,166,158,8
1144,CONNECTICUT,New Canaan,20147.0,53,47,6
1145,CONNECTICUT,New Haven,130903.0,361,315,46
1146,CONNECTICUT,Newington,29803.0,62,49,13
1147,CONNECTICUT,New London,26797.0,82,67,15
1148,CONNECTICUT,New Milford,26548.0,61,48,13
1149,CONNECTICUT,Newtown,27858.0,58,45,13
1150,CONNECTICUT,North Branford,14031.0,30,23,7
1151,CONNECTICUT,North Haven,23504.0,59,49,10
1152,CONNECTICUT,Norwalk,88930.0,197,164,33
1153,CONNECTICUT,Norwich,38431.0,96,82,14
1154,CONNECTICUT,Old Saybrook,10007.0,33,22,11
1155,CONNECTICUT,Orange,13874.0,51,42,9
1156,CONNECTICUT,Plainfield,15053.0,23,18,5
1157,CONNECTICUT,Plainville,17466.0,51,39,12
1158,CONNECTICUT,Plymouth,11486.0,25,23,2
1159,CONNECTICUT,Portland,9185.0,13,12,1
1160,CONNECTICUT,Putnam,9354.0,20,15,5
1161,CONNECTICUT,Redding,9042.0,22,16,6
1162,CONNECTICUT,Ridgefield,24919.0,47,41,6
1163,CONNECTICUT,Rocky Hill,20069.0,51,39,12
1164,CONNECTICUT,Seymour,16306.0,39,37,2
1165,CONNECTICUT,Shelton,41095.0,62,53,9
1166,CONNECTICUT,Simsbury,25639.0,50,39,11
1167,CONNECTICUT,Southington,43897.0,88,67,21
1168,CONNECTICUT,South Windsor,26142.0,58,44,14
1169,CONNECTICUT,Stamford,132292.0,282,260,22
1170,CONNECTICUT,Stonington,18571.0,52,39,13
1171,CONNECTICUT,Stratford,51683.0,109,103,6
1172,CONNECTICUT,Suffield,15817.0,25,20,5
1173,CONNECTICUT,Thomaston,7468.0,25,13,12
1174,CONNECTICUT,Torrington,33631.0,83,73,10
1175,CONNECTICUT,Trumbull,35378.0,82,73,9
1176,CONNECTICUT,Vernon,29423.0,57,45,12
1177,CONNECTICUT,Wallingford,43969.0,87,68,19
1178,CONNECTICUT,Waterbury,106480.0,319,276,43
1179,CONNECTICUT,Waterford,18803.0,60,44,16
1180,CONNECTICUT,Watertown,21418.0,49,39,10
1181,CONNECTICUT,West Hartford,62809.0,144,122,22
1182,CONNECTICUT,West Haven,54248.0,126,118,8
1183,CONNECTICUT,Weston,10204.0,18,17,1
1184,CONNECTICUT,Westport,28652.0,71,61,10
1185,CONNECTICUT,Wethersfield,25807.0,54,42,12
1186,CONNECTICUT,Willimantic,17763.0,48,43,5
1187,CONNECTICUT,Wilton,18236.0,45,41,4
1188,CONNECTICUT,Winchester,10481.0,21,20,1
1189,CONNECTICUT,Windsor,28601.0,57,45,12
1190,CONNECTICUT,Windsor Locks,12828.0,34,26,8
1191,CONNECTICUT,Wolcott,16550.0,37,26,11
1192,CONNECTICUT,Woodbridge,8676.0,31,23,8
1193,DELAWARE,Bethany Beach,1308.0,11,10,1
1194,DELAWARE,Blades,1526.0,2,2,0
1195,DELAWARE,Bridgeville,2487.0,8,8,0
1196,DELAWARE,Camden,3660.0,10,9,1
1197,DELAWARE,Cheswold,1787.0,4,4,0
1198,DELAWARE,Clayton,3707.0,10,9,1
1199,DELAWARE,Dagsboro,973.0,4,4,0
1200,DELAWARE,Delaware City,1852.0,4,3,1
1201,DELAWARE,Delmar,1911.0,12,11,1
1202,DELAWARE,Dewey Beach,419.0,13,10,3
1203,DELAWARE,Dover,38439.0,133,102,31
1204,DELAWARE,Ellendale,457.0,1,1,0
1205,DELAWARE,Elsmere,5741.0,13,12,1
1206,DELAWARE,Felton,1447.0,4,4,0
1207,DELAWARE,Fenwick Island,468.0,8,7,1
1208,DELAWARE,Frederica,869.0,2,2,0
1209,DELAWARE,Georgetown,7945.0,19,16,3
1210,DELAWARE,Greenwood,1197.0,4,3,1
1211,DELAWARE,Harrington,3672.0,13,12,1
1212,DELAWARE,Laurel,4595.0,19,18,1
1213,DELAWARE,Lewes,3479.0,12,11,1
1214,DELAWARE,Middletown,24307.0,43,37,6
1215,DELAWARE,Milford,12582.0,44,32,12
1216,DELAWARE,Millsboro,4753.0,19,17,2
1217,DELAWARE,Milton,3189.0,9,8,1
1218,DELAWARE,Newark,34064.0,87,70,17
1219,DELAWARE,New Castle,5419.0,17,16,1
1220,DELAWARE,Newport,871.0,6,6,0
1221,DELAWARE,Ocean View,2290.0,14,13,1
1222,DELAWARE,Rehoboth Beach,1622.0,33,19,14
1223,DELAWARE,Seaford,8392.0,33,27,6
1224,DELAWARE,Smyrna,12383.0,36,28,8
1225,DELAWARE,South Bethany,557.0,6,6,0
1226,DELAWARE,Wilmington,70331.0,353,302,51
1227,DELAWARE,Wyoming,1695.0,3,3,0
1228,DISTRICT OF COLUMBIA,Washington,670050.0,4179,3575,604
1229,FLORIDA,Alachua,10006.0,35,27,8
1230,FLORIDA,Altamonte Springs,44030.0,111,95,16
1231,FLORIDA,Apopka,55173.0,137,102,35
1232,FLORIDA,Arcadia,8523.0,21,17,4
1233,FLORIDA,Astatula,2156.0,8,8,0
1234,FLORIDA,Atlantic Beach,13971.0,42,30,12
1235,FLORIDA,Atlantis,2140.0,16,11,5
1236,FLORIDA,Auburndale,17633.0,42,33,9
1237,FLORIDA,Aventura,36621.0,125,93,32
1238,FLORIDA,Bal Harbour Village,2946.0,36,25,11
1239,FLORIDA,Bartow,20534.0,61,41,20
1240,FLORIDA,Bay Harbor Islands,5731.0,30,24,6
1241,FLORIDA,Belleair,4339.0,15,13,2
1242,FLORIDA,Belle Isle,7437.0,20,17,3
1243,FLORIDA,Belleview,5279.0,16,14,2
1244,FLORIDA,Biscayne Park,3012.0,11,11,0
1245,FLORIDA,Blountstown,2421.0,21,14,7
1246,FLORIDA,Boca Raton,101504.0,303,207,96
1247,FLORIDA,Bonifay,2685.0,6,5,1
1248,FLORIDA,Bowling Green,2891.0,6,6,0
1249,FLORIDA,Boynton Beach,81384.0,184,146,38
1250,FLORIDA,Bradenton,60902.0,154,119,35
1251,FLORIDA,Bradenton Beach,1284.0,9,9,0
1252,FLORIDA,Cape Coral,206298.0,360,272,88
1253,FLORIDA,Casselberry,29778.0,63,53,10
1254,FLORIDA,Cedar Key,726.0,4,4,0
1255,FLORIDA,Clearwater,117336.0,329,237,92
1256,FLORIDA,Clermont,41160.0,87,78,9
1257,FLORIDA,Clewiston,8202.0,18,13,5
1258,FLORIDA,Cocoa,18854.0,91,62,29
1259,FLORIDA,Cocoa Beach,11695.0,51,34,17
1260,FLORIDA,Coconut Creek,58166.0,145,107,38
1261,FLORIDA,Cooper City,34599.0,72,56,16
1262,FLORIDA,Coral Gables,49356.0,283,193,90
1263,FLORIDA,Coral Springs,135168.0,313,215,98
1264,FLORIDA,Crestview,26173.0,48,39,9
1265,FLORIDA,Cross City,1743.0,4,4,0
1266,FLORIDA,Dade City,7809.0,32,24,8
1267,FLORIDA,Dania Beach,31906.0,82,76,6
1268,FLORIDA,Davenport,8025.0,16,15,1
1269,FLORIDA,Daytona Beach,71059.0,275,217,58
1270,FLORIDA,Daytona Beach Shores,4681.0,35,27,8
1271,FLORIDA,Deerfield Beach,87359.0,140,130,10
1272,FLORIDA,DeFuniak Springs,7440.0,29,21,8
1273,FLORIDA,DeLand,37089.0,83,67,16
1274,FLORIDA,Delray Beach,70524.0,216,154,62
1275,FLORIDA,Doral,70496.0,198,147,51
1276,FLORIDA,Dunnellon,1881.0,11,10,1
1277,FLORIDA,Eatonville,2196.0,15,13,2
1278,FLORIDA,Edgewater,24403.0,34,29,5
1279,FLORIDA,Edgewood,3095.0,16,13,3
1280,FLORIDA,El Portal,2350.0,10,10,0
1281,FLORIDA,Eustis,21636.0,51,38,13
1282,FLORIDA,Fellsmere,5814.0,11,9,2
1283,FLORIDA,Fernandina Beach,13499.0,42,37,5
1284,FLORIDA,Flagler Beach,5220.0,18,15,3
1285,FLORIDA,Florida City,11704.0,42,33,9
1286,FLORIDA,Fort Lauderdale,183810.0,664,502,162
1287,FLORIDA,Fort Myers,94586.0,324,238,86
1288,FLORIDA,Fort Pierce,46794.0,141,113,28
1289,FLORIDA,Fort Walton Beach,22713.0,76,51,25
1290,FLORIDA,Fruitland Park,12226.0,22,21,1
1291,FLORIDA,Gainesville,136085.0,333,247,86
1292,FLORIDA,Golden Beach,932.0,22,17,5
1293,FLORIDA,Graceville,2090.0,8,8,0
1294,FLORIDA,Green Cove Springs,9148.0,28,21,7
1295,FLORIDA,Gretna,1407.0,4,4,0
1296,FLORIDA,Groveland,19309.0,55,40,15
1297,FLORIDA,Gulf Breeze,7219.0,23,23,0
1298,FLORIDA,Gulfport,12311.0,33,29,4
1299,FLORIDA,Gulf Stream,998.0,13,13,0
1300,FLORIDA,Haines City,28535.0,69,56,13
1301,FLORIDA,Hallandale Beach,41454.0,119,86,33
1302,FLORIDA,Hialeah,232699.0,353,288,65
1303,FLORIDA,Hialeah Gardens,23348.0,60,45,15
1304,FLORIDA,Highland Beach,3944.0,15,14,1
1305,FLORIDA,Hillsboro Beach,2024.0,19,15,4
1306,FLORIDA,Holly Hill,12477.0,26,22,4
1307,FLORIDA,Hollywood,153948.0,407,314,93
1308,FLORIDA,Holmes Beach,4353.0,25,18,7
1309,FLORIDA,Homestead,70179.0,154,120,34
1310,FLORIDA,Howey-in-the-Hills,1190.0,8,8,0
1311,FLORIDA,Indialantic,2913.0,18,12,6
1312,FLORIDA,Indian Creek Village,88.0,14,10,4
1313,FLORIDA,Indian Harbour Beach,8553.0,29,20,9
1314,FLORIDA,Indian River Shores,4396.0,22,18,4
1315,FLORIDA,Indian Shores,3774.0,14,13,1
1316,FLORIDA,Interlachen,1478.0,3,3,0
1317,FLORIDA,Jacksonville Beach,23846.0,85,65,20
1318,FLORIDA,Juno Beach,3657.0,16,14,2
1319,FLORIDA,Jupiter,66986.0,140,114,26
1320,FLORIDA,Jupiter Inlet Colony,456.0,4,4,0
1321,FLORIDA,Jupiter Island,954.0,23,18,5
1322,FLORIDA,Kenneth City,5095.0,14,13,1
1323,FLORIDA,Key Biscayne,12765.0,43,33,10
1324,FLORIDA,Key Colony Beach,795.0,4,4,0
1325,FLORIDA,Kissimmee,74334.0,225,152,73
1326,FLORIDA,Lady Lake,16410.0,34,29,5
1327,FLORIDA,Lake Alfred,6492.0,14,10,4
1328,FLORIDA,Lake City,12478.0,51,35,16
1329,FLORIDA,Lake Clarke Shores,3641.0,9,8,1
1330,FLORIDA,Lake Hamilton,1578.0,8,6,2
1331,FLORIDA,Lake Helen,2846.0,7,6,1
1332,FLORIDA,Lakeland,117214.0,355,248,107
1333,FLORIDA,Lake Mary,17908.0,53,45,8
1334,FLORIDA,Lake Placid,2514.0,8,6,2
1335,FLORIDA,Lake Wales,18092.0,54,46,8
1336,FLORIDA,Lantana,12775.0,39,29,10
1337,FLORIDA,Largo,85244.0,188,155,33
1338,FLORIDA,Lauderdale-by-the-Sea,6234.0,27,25,2
1339,FLORIDA,Lauderdale Lakes,36161.0,46,38,8
1340,FLORIDA,Lauderhill,74911.0,160,118,42
1341,FLORIDA,Lawtey,741.0,2,2,0
1342,FLORIDA,Leesburg,24459.0,95,70,25
1343,FLORIDA,Lighthouse Point,10546.0,42,31,11
1344,FLORIDA,Live Oak,7004.0,20,17,3
1345,FLORIDA,Longboat Key,7346.0,17,16,1
1346,FLORIDA,Longwood,17245.0,45,41,4
1347,FLORIDA,Lynn Haven,20390.0,48,37,11
1348,FLORIDA,Madison,2766.0,17,16,1
1349,FLORIDA,Maitland,17621.0,58,50,8
1350,FLORIDA,Manalapan,476.0,14,12,2
1351,FLORIDA,Marco Island,18262.0,44,39,5
1352,FLORIDA,Margate,59050.0,142,108,34
1353,FLORIDA,Marianna,5564.0,23,17,6
1354,FLORIDA,Mascotte,7030.0,15,13,2
1355,FLORIDA,Melbourne,84112.0,232,162,70
1356,FLORIDA,Melbourne Beach,3319.0,12,11,1
1357,FLORIDA,Melbourne Village,695.0,5,5,0
1358,FLORIDA,Miami,479262.0,1696,1275,421
1359,FLORIDA,Miami Beach,87729.0,504,414,90
1360,FLORIDA,Miami Gardens,109296.0,252,206,46
1361,FLORIDA,Miami Shores,10209.0,40,34,6
1362,FLORIDA,Miami Springs,13716.0,55,45,10
1363,FLORIDA,Midway,2948.0,6,5,1
1364,FLORIDA,Milton,11001.0,20,15,5
1365,FLORIDA,Miramar,135497.0,292,207,85
1366,FLORIDA,Monticello,2447.0,13,9,4
1367,FLORIDA,Mount Dora,15065.0,60,42,18
1368,FLORIDA,Naples,22277.0,90,61,29
1369,FLORIDA,Neptune Beach,7236.0,30,22,8
1370,FLORIDA,New Port Richey,17259.0,61,43,18
1371,FLORIDA,New Smyrna Beach,29314.0,62,49,13
1372,FLORIDA,Niceville,16584.0,32,23,9
1373,FLORIDA,North Bay Village,8044.0,34,28,6
1374,FLORIDA,North Lauderdale,45052.0,64,57,7
1375,FLORIDA,North Miami,62442.0,138,109,29
1376,FLORIDA,North Miami Beach,42592.0,136,100,36
1377,FLORIDA,North Palm Beach,13221.0,36,31,5
1378,FLORIDA,North Port,75614.0,165,123,42
1379,FLORIDA,Oakland,3218.0,15,13,2
1380,FLORIDA,Oakland Park,44484.0,97,86,11
1381,FLORIDA,Ocala,62206.0,309,186,123
1382,FLORIDA,Ocean Ridge,1975.0,21,16,5
1383,FLORIDA,Ocoee,50741.0,107,94,13
1384,FLORIDA,Okeechobee,5681.0,32,23,9
1385,FLORIDA,Opa Locka,15707.0,52,40,12
1386,FLORIDA,Orange City,12803.0,28,24,4
1387,FLORIDA,Orange Park,8808.0,35,26,9
1388,FLORIDA,Orlando,295040.0,1042,822,220
1389,FLORIDA,Ormond Beach,44535.0,80,61,19
1390,FLORIDA,Oviedo,42565.0,77,70,7
1391,FLORIDA,Palatka,10445.0,29,27,2
1392,FLORIDA,Palm Bay,118296.0,204,146,58
1393,FLORIDA,Palm Beach,8905.0,90,66,24
1394,FLORIDA,Palm Beach Gardens,59100.0,178,121,57
1395,FLORIDA,Palmetto,13914.0,47,35,12
1396,FLORIDA,Palm Springs,25583.0,62,43,19
1397,FLORIDA,Panama City,33651.0,121,84,37
1398,FLORIDA,Panama City Beach,12415.0,91,74,17
1399,FLORIDA,Parker,4089.0,10,9,1
1400,FLORIDA,Parkland,34870.0,55,50,5
1401,FLORIDA,Pembroke Pines,172163.0,340,244,96
1402,FLORIDA,Pensacola,53255.0,198,145,53
1403,FLORIDA,Perry,6862.0,23,21,2
1404,FLORIDA,Pinellas Park,55416.0,123,105,18
1405,FLORIDA,Plantation,92278.0,252,166,86
1406,FLORIDA,Plant City,40115.0,81,66,15
1407,FLORIDA,Pompano Beach,112691.0,273,243,30
1408,FLORIDA,Ponce Inlet,3367.0,15,13,2
1409,FLORIDA,Port Orange,66380.0,116,82,34
1410,FLORIDA,Port Richey,3080.0,24,17,7
1411,FLORIDA,Port St. Joe,3517.0,10,8,2
1412,FLORIDA,Port St. Lucie,214836.0,319,248,71
1413,FLORIDA,Punta Gorda,21094.0,55,37,18
1414,FLORIDA,Quincy,6689.0,33,23,10
1415,FLORIDA,Riviera Beach,35981.0,148,104,44
1416,FLORIDA,Rockledge,28605.0,66,49,17
1417,FLORIDA,Sanford,62320.0,157,131,26
1418,FLORIDA,Sanibel,7531.0,40,25,15
1419,FLORIDA,Sarasota,59569.0,230,178,52
1420,FLORIDA,Satellite Beach,11233.0,36,25,11
1421,FLORIDA,Sea Ranch Lakes,625.0,12,8,4
1422,FLORIDA,Sebastian,26982.0,59,41,18
1423,FLORIDA,Sebring,10645.0,44,39,5
1424,FLORIDA,Sewall's Point,2265.0,9,8,1
1425,FLORIDA,Shalimar,854.0,3,3,0
1426,FLORIDA,Sneads,1746.0,7,6,1
1427,FLORIDA,South Daytona,13788.0,34,28,6
1428,FLORIDA,South Miami,11816.0,53,48,5
1429,FLORIDA,Springfield,8169.0,27,22,5
1430,FLORIDA,Starke,5470.0,21,19,2
1431,FLORIDA,St. Augustine Beach,7241.0,22,19,3
1432,FLORIDA,St. Cloud,58896.0,127,89,38
1433,FLORIDA,St. Petersburg,270175.0,750,551,199
1434,FLORIDA,Stuart,16801.0,61,45,16
1435,FLORIDA,Sunny Isles Beach,21709.0,62,51,11
1436,FLORIDA,Sunrise,97895.0,236,177,59
1437,FLORIDA,Surfside,5571.0,35,30,5
1438,FLORIDA,Tallahassee,197883.0,445,367,78
1439,FLORIDA,Tamarac,72311.0,99,82,17
1440,FLORIDA,Tampa,415413.0,1177,919,258
1441,FLORIDA,Tavares,18266.0,30,28,2
1442,FLORIDA,Temple Terrace,27035.0,68,51,17
1443,FLORIDA,Tequesta,6178.0,21,20,1
1444,FLORIDA,Titusville,46921.0,127,87,40
1445,FLORIDA,Treasure Island,6911.0,21,17,4
1446,FLORIDA,Trenton,2208.0,4,3,1
1447,FLORIDA,Umatilla,3942.0,9,8,1
1448,FLORIDA,Valparaiso,5941.0,15,10,5
1449,FLORIDA,Vero Beach,18049.0,77,57,20
1450,FLORIDA,Village of Pinecrest,19080.0,69,45,24
1451,FLORIDA,Virginia Gardens,2342.0,8,7,1
1452,FLORIDA,Wauchula,4757.0,18,15,3
1453,FLORIDA,Welaka,720.0,1,1,0
1454,FLORIDA,West Melbourne,27796.0,50,43,7
1455,FLORIDA,West Miami,9095.0,27,22,5
1456,FLORIDA,West Palm Beach,114055.0,389,288,101
1457,FLORIDA,West Park,15217.0,46,42,4
1458,FLORIDA,Wildwood,7976.0,44,39,5
1459,FLORIDA,Wilton Manors,11492.0,44,29,15
1460,FLORIDA,Winter Garden,48011.0,110,82,28
1461,FLORIDA,Winter Haven,47974.0,108,86,22
1462,FLORIDA,Winter Park,30971.0,107,81,26
1463,FLORIDA,Winter Springs,37864.0,59,51,8
1464,FLORIDA,Zephyrhills,17368.0,47,33,14
1465,GEORGIA,Abbeville,2626.0,5,4,1
1466,GEORGIA,Acworth,22956.0,68,45,23
1467,GEORGIA,Adairsville,5094.0,18,16,2
1468,GEORGIA,Alamo,3320.0,2,2,0
1469,GEORGIA,Alapaha,673.0,2,1,1
1470,GEORGIA,Albany,70214.0,150,128,22
1471,GEORGIA,Alma,3322.0,17,15,2
1472,GEORGIA,Alpharetta,68954.0,132,100,32
1473,GEORGIA,Alto,1209.0,5,2,3
1474,GEORGIA,Americus,14798.0,41,31,10
1475,GEORGIA,Arcade,2064.0,4,4,0
1476,GEORGIA,Athens-Clarke County,127410.0,270,210,60
1477,GEORGIA,Atlanta,521274.0,2095,1641,454
1478,GEORGIA,Austell,7280.0,33,27,6
1479,GEORGIA,Avondale Estates,3126.0,12,12,0
1480,GEORGIA,Bainbridge,12074.0,55,47,8
1481,GEORGIA,Ball Ground,2414.0,5,5,0
1482,GEORGIA,Barnesville,6660.0,20,20,0
1483,GEORGIA,Bartow,246.0,3,3,0
1484,GEORGIA,Baxley,4646.0,13,12,1
1485,GEORGIA,Blackshear,3529.0,22,19,3
1486,GEORGIA,Blairsville,660.0,8,7,1
1487,GEORGIA,Blakely,4439.0,18,14,4
1488,GEORGIA,Bloomingdale,3194.0,16,14,2
1489,GEORGIA,Blue Ridge,1486.0,8,8,0
1490,GEORGIA,Blythe,698.0,1,1,0
1491,GEORGIA,Boston,1313.0,5,5,0
1492,GEORGIA,Bowdon,2096.0,8,7,1
1493,GEORGIA,Braselton,14568.0,20,19,1
1494,GEORGIA,Braswell ,387.0,2,1,1
1495,GEORGIA,Bremen,6880.0,19,18,1
1496,GEORGIA,Brookhaven,56770.0,88,74,14
1497,GEORGIA,Brooklet,2001.0,6,5,1
1498,GEORGIA,Broxton,1198.0,6,5,1
1499,GEORGIA,Brunswick,16387.0,46,40,6
1500,GEORGIA,Butler,1797.0,4,4,0
1501,GEORGIA,Byron,5350.0,28,25,3
1502,GEORGIA,Cairo,9269.0,26,23,3
1503,GEORGIA,Calhoun,17719.0,51,43,8
1504,GEORGIA,Camilla,4907.0,22,19,3
1505,GEORGIA,Canon,791.0,1,1,0
1506,GEORGIA,Canton,33386.0,56,48,8
1507,GEORGIA,Carrollton,27786.0,87,73,14
1508,GEORGIA,Cartersville,22276.0,51,44,7
1509,GEORGIA,Cave Spring,1065.0,3,3,0
1510,GEORGIA,Cecil,285.0,4,3,1
1511,GEORGIA,Cedartown,9999.0,35,31,4
1512,GEORGIA,Centerville,8082.0,18,15,3
1513,GEORGIA,Chamblee,31254.0,78,62,16
1514,GEORGIA,Chatsworth,4246.0,18,17,1
1515,GEORGIA,Chickamauga,3235.0,5,5,0
1516,GEORGIA,Clarkston,12677.0,15,15,0
1517,GEORGIA,Claxton,2200.0,17,10,7
1518,GEORGIA,Clayton,2122.0,12,11,1
1519,GEORGIA,Cleveland,4246.0,17,16,1
1520,GEORGIA,Cochran,5013.0,10,9,1
1521,GEORGIA,Cohutta,644.0,3,3,0
1522,GEORGIA,College Park,15241.0,105,77,28
1523,GEORGIA,Columbus,196633.0,429,336,93
1524,GEORGIA,Conyers,16235.0,92,66,26
1525,GEORGIA,Coolidge,523.0,2,2,0
1526,GEORGIA,Cordele,10223.0,32,23,9
1527,GEORGIA,Cornelia,4865.0,19,17,2
1528,GEORGIA,Covington,14517.0,64,52,12
1529,GEORGIA,Cumming,6765.0,23,20,3
1530,GEORGIA,Dallas,14704.0,36,26,10
1531,GEORGIA,Dalton,33389.0,93,82,11
1532,GEORGIA,Danielsville,605.0,4,4,0
1533,GEORGIA,Darien,1848.0,11,10,1
1534,GEORGIA,Davisboro,1952.0,3,3,0
1535,GEORGIA,Dawson,4076.0,11,7,4
1536,GEORGIA,Decatur,26350.0,50,39,11
1537,GEORGIA,Demorest,2174.0,10,7,3
1538,GEORGIA,Dillard,374.0,4,3,1
1539,GEORGIA,Doerun,726.0,6,5,1
1540,GEORGIA,Donalsonville,2471.0,12,9,3
1541,GEORGIA,Doraville,10322.0,62,44,18
1542,GEORGIA,Douglas,11606.0,40,36,4
1543,GEORGIA,Douglasville,34475.0,104,88,16
1544,GEORGIA,Dublin,15767.0,65,57,8
1545,GEORGIA,Duluth,29986.0,76,59,17
1546,GEORGIA,Dunwoody ,49621.0,66,54,12
1547,GEORGIA,East Ellijay,573.0,14,6,8
1548,GEORGIA,Eastman,5054.0,12,10,2
1549,GEORGIA,East Point,35156.0,109,72,37
1550,GEORGIA,Eatonton,6878.0,20,12,8
1551,GEORGIA,Edison,1394.0,5,4,1
1552,GEORGIA,Elberton,4328.0,23,20,3
1553,GEORGIA,Ellaville,1835.0,5,5,0
1554,GEORGIA,Ellijay,1736.0,10,9,1
1555,GEORGIA,Emerson,1602.0,12,11,1
1556,GEORGIA,Enigma,1354.0,3,2,1
1557,GEORGIA,Eton,890.0,4,4,0
1558,GEORGIA,Euharlee,4450.0,12,10,2
1559,GEORGIA,Fairburn,17583.0,50,41,9
1560,GEORGIA,Fairmount,745.0,7,7,0
1561,GEORGIA,Fayetteville,18554.0,57,48,9
1562,GEORGIA,Fitzgerald,8563.0,31,24,7
1563,GEORGIA,Flowery Branch,9155.0,19,17,2
1564,GEORGIA,Folkston,5074.0,7,7,0
1565,GEORGIA,Forest Park,20015.0,78,48,30
1566,GEORGIA,Forsyth,4346.0,19,17,2
1567,GEORGIA,Fort Oglethorpe,10046.0,27,24,3
1568,GEORGIA,Fort Valley,8906.0,33,24,9
1569,GEORGIA,Franklin,956.0,8,8,0
1570,GEORGIA,Franklin Springs,1214.0,2,2,0
1571,GEORGIA,Gainesville,45385.0,107,93,14
1572,GEORGIA,Garden City,9268.0,41,32,9
1573,GEORGIA,Gordon,1801.0,11,6,5
1574,GEORGIA,Grantville,3369.0,14,13,1
1575,GEORGIA,Gray,3240.0,14,13,1
1576,GEORGIA,Greensboro,3262.0,21,17,4
1577,GEORGIA,Greenville,831.0,8,7,1
1578,GEORGIA,Griffin,22617.0,86,69,17
1579,GEORGIA,Grovetown,17293.0,23,17,6
1580,GEORGIA,Guyton,2455.0,7,7,0
1581,GEORGIA,Hagan,950.0,5,3,2
1582,GEORGIA,Hahira,3080.0,15,9,6
1583,GEORGIA,Hampton,8313.0,19,17,2
1584,GEORGIA,Hapeville,6601.0,37,26,11
1585,GEORGIA,Harlem,3648.0,7,6,1
1586,GEORGIA,Hartwell,4453.0,23,18,5
1587,GEORGIA,Hazlehurst,4072.0,14,11,3
1588,GEORGIA,Helen,564.0,11,10,1
1589,GEORGIA,Hephzibah,3926.0,10,10,0
1590,GEORGIA,Hiawassee,923.0,5,5,0
1591,GEORGIA,Hinesville,34211.0,91,75,16
1592,GEORGIA,Hiram,4315.0,20,17,3
1593,GEORGIA,Hoboken,542.0,3,1,2
1594,GEORGIA,Hogansville,3155.0,17,12,5
1595,GEORGIA,Holly Springs,17484.0,38,36,2
1596,GEORGIA,Homerville,2335.0,7,5,2
1597,GEORGIA,Jackson,5361.0,15,14,1
1598,GEORGIA,Jacksonville,125.0,3,2,1
1599,GEORGIA,Jasper,4074.0,16,14,2
1600,GEORGIA,Jefferson,12833.0,27,24,3
1601,GEORGIA,Johns Creek,85974.0,85,75,10
1602,GEORGIA,Jonesboro,5164.0,30,25,5
1603,GEORGIA,Kennesaw,35145.0,72,62,10
1604,GEORGIA,Kingsland,18556.0,39,34,5
1605,GEORGIA,Kingston,751.0,4,2,2
1606,GEORGIA,LaFayette,7547.0,26,24,2
1607,GEORGIA,LaGrange,30874.0,105,85,20
1608,GEORGIA,Lake City,2818.0,12,11,1
1609,GEORGIA,Lakeland,3339.0,9,7,2
1610,GEORGIA,Lake Park,1464.0,4,3,1
1611,GEORGIA,Lavonia,2191.0,14,13,1
1612,GEORGIA,Lawrenceville,31223.0,96,73,23
1613,GEORGIA,Leesburg,3098.0,13,13,0
1614,GEORGIA,Lilburn,13199.0,37,31,6
1615,GEORGIA,Locust Grove,9513.0,27,24,3
1616,GEORGIA,Loganville,13633.0,30,28,2
1617,GEORGIA,Lookout Mountain,1566.0,7,7,0
1618,GEORGIA,Louisville,2162.0,5,5,0
1619,GEORGIA,Lovejoy,7742.0,25,21,4
1620,GEORGIA,Madison,4286.0,16,14,2
1621,GEORGIA,Manchester,3890.0,18,12,6
1622,GEORGIA,Marietta,61223.0,179,132,47
1623,GEORGIA,Maysville,2212.0,4,4,0
1624,GEORGIA,McDonough,28222.0,50,44,6
1625,GEORGIA,McIntyre,593.0,3,3,0
1626,GEORGIA,McRae-Helena,8250.0,11,10,1
1627,GEORGIA,Metter,4000.0,14,13,1
1628,GEORGIA,Midville,250.0,1,1,0
1629,GEORGIA,Midway,2010.0,7,5,2
1630,GEORGIA,Milledgeville,18551.0,55,39,16
1631,GEORGIA,Millen,2730.0,12,12,0
1632,GEORGIA,Milton,40781.0,45,41,4
1633,GEORGIA,Monroe,14091.0,54,51,3
1634,GEORGIA,Montezuma,2870.0,12,9,3
1635,GEORGIA,Morrow,7254.0,26,25,1
1636,GEORGIA,Moultrie,14133.0,40,36,4
1637,GEORGIA,Mount Zion,1907.0,6,6,0
1638,GEORGIA,Nahunta,1178.0,2,2,0
1639,GEORGIA,Nashville,4797.0,21,17,4
1640,GEORGIA,Newington,263.0,1,1,0
1641,GEORGIA,Newnan,44023.0,100,87,13
1642,GEORGIA,Newton,549.0,1,1,0
1643,GEORGIA,Norcross,18337.0,56,40,16
1644,GEORGIA,Oakwood,4342.0,25,23,2
1645,GEORGIA,Ocilla,3746.0,14,13,1
1646,GEORGIA,Oglethorpe,1109.0,4,3,1
1647,GEORGIA,Omega,1222.0,6,6,0
1648,GEORGIA,Oxford,2359.0,3,3,0
1649,GEORGIA,Palmetto,5010.0,18,16,2
1650,GEORGIA,Peachtree City,36994.0,68,63,5
1651,GEORGIA,Pearson,2088.0,6,5,1
1652,GEORGIA,Pelham,3362.0,14,12,2
1653,GEORGIA,Pembroke,2743.0,13,11,2
1654,GEORGIA,Pendergrass ,593.0,4,4,0
1655,GEORGIA,Perry,19469.0,45,40,5
1656,GEORGIA,Pine Mountain,1468.0,11,8,3
1657,GEORGIA,Pooler,26911.0,70,59,11
1658,GEORGIA,Port Wentworth,10416.0,46,41,5
1659,GEORGIA,Poulan,761.0,4,4,0
1660,GEORGIA,Remerton,1054.0,9,8,1
1661,GEORGIA,Reynolds,942.0,7,7,0
1662,GEORGIA,Richmond Hill,15025.0,42,34,8
1663,GEORGIA,Rincon,10836.0,20,18,2
1664,GEORGIA,Ringgold,3508.0,10,9,1
1665,GEORGIA,Riverdale,15643.0,43,35,8
1666,GEORGIA,Rochelle,1072.0,6,3,3
1667,GEORGIA,Rockmart,4520.0,22,20,2
1668,GEORGIA,Rome,36792.0,88,79,9
1669,GEORGIA,Rossville,3986.0,12,11,1
1670,GEORGIA,Roswell,96041.0,195,151,44
1671,GEORGIA,Royston,2561.0,10,8,2
1672,GEORGIA,Sandersville,5215.0,19,15,4
1673,GEORGIA,Sandy Springs,111533.0,160,139,21
1674,GEORGIA,Sardis,967.0,1,1,0
1675,GEORGIA,Senoia,4654.0,18,15,3
1676,GEORGIA,Shiloh,501.0,4,4,0
1677,GEORGIA,Sky Valley,273.0,5,5,0
1678,GEORGIA,Smyrna,57024.0,131,83,48
1679,GEORGIA,Snellville,20382.0,58,46,12
1680,GEORGIA,Social Circle,4674.0,18,17,1
1681,GEORGIA,South Fulton,104282.0,158,139,19
1682,GEORGIA,Sparta,1205.0,11,4,7
1683,GEORGIA,Springfield,4237.0,8,7,1
1684,GEORGIA,Statesboro,33722.0,89,72,17
1685,GEORGIA,Statham,2931.0,9,7,2
1686,GEORGIA,St. Marys,19021.0,27,23,4
1687,GEORGIA,Stone Mountain,6357.0,16,15,1
1688,GEORGIA,Summerville,4213.0,17,15,2
1689,GEORGIA,Suwanee,22579.0,45,33,12
1690,GEORGIA,Swainsboro,7517.0,25,23,2
1691,GEORGIA,Sylvania,2438.0,13,10,3
1692,GEORGIA,Sylvester,5642.0,19,16,3
1693,GEORGIA,Tallapoosa,3237.0,12,10,2
1694,GEORGIA,Temple,5104.0,14,11,3
1695,GEORGIA,Thomaston,8735.0,27,23,4
1696,GEORGIA,Thomasville,18485.0,56,50,6
1697,GEORGIA,Thunderbolt,2609.0,9,7,2
1698,GEORGIA,Toccoa,8283.0,22,20,2
1699,GEORGIA,Trenton,2139.0,8,8,0
1700,GEORGIA,Tunnel Hill,892.0,4,4,0
1701,GEORGIA,Twin City,1693.0,3,3,0
1702,GEORGIA,Tybee Island,3057.0,37,25,12
1703,GEORGIA,Tyrone,7803.0,16,16,0
1704,GEORGIA,Union City,23707.0,61,56,5
1705,GEORGIA,Valdosta,56844.0,156,131,25
1706,GEORGIA,Vidalia,10452.0,36,26,10
1707,GEORGIA,Vienna,3436.0,4,3,1
1708,GEORGIA,Villa Rica,17094.0,54,46,8
1709,GEORGIA,Walthourville,4060.0,6,5,1
1710,GEORGIA,Warm Springs,400.0,2,2,0
1711,GEORGIA,Warner Robins,79483.0,150,108,42
1712,GEORGIA,Watkinsville,2973.0,8,7,1
1713,GEORGIA,Waverly Hall,830.0,4,3,1
1714,GEORGIA,Waycross,13359.0,65,51,14
1715,GEORGIA,Waynesboro,5340.0,25,22,3
1716,GEORGIA,West Point,3750.0,31,20,11
1717,GEORGIA,Whigham,461.0,2,1,1
1718,GEORGIA,Whitesburg,617.0,6,6,0
1719,GEORGIA,Willacoochee,1389.0,4,3,1
1720,GEORGIA,Winder,18709.0,41,34,7
1721,GEORGIA,Woodstock,34798.0,66,59,7
1722,GEORGIA,Wrens,1900.0,10,9,1
1723,GEORGIA,Zebulon,1229.0,7,7,0
1724,HAWAII,Honolulu,985138.0,2437,1942,495
1725,IDAHO,American Falls,4280.0,9,7,2
1726,IDAHO,Ashton,1034.0,2,2,0
1727,IDAHO,Bellevue,2519.0,5,5,0
1728,IDAHO,Blackfoot,12026.0,30,27,3
1729,IDAHO,Boise,231902.0,357,280,77
1730,IDAHO,Bonners Ferry,2712.0,7,7,0
1731,IDAHO,Buhl,4560.0,10,8,2
1732,IDAHO,Caldwell,62306.0,87,73,14
1733,IDAHO,Chubbuck,16168.0,35,21,14
1734,IDAHO,Coeur d'Alene,54358.0,112,90,22
1735,IDAHO,Cottonwood,984.0,1,1,0
1736,IDAHO,Emmett,7346.0,15,13,2
1737,IDAHO,Filer,2984.0,5,5,0
1738,IDAHO,Fruitland,5655.0,18,14,4
1739,IDAHO,Garden City,12018.0,36,28,8
1740,IDAHO,Grangeville,3272.0,5,5,0
1741,IDAHO,Hailey,8988.0,12,11,1
1742,IDAHO,Heyburn,3496.0,6,5,1
1743,IDAHO,Homedale,2851.0,8,7,1
1744,IDAHO,Idaho City,484.0,1,1,0
1745,IDAHO,Idaho Falls,64792.0,135,92,43
1746,IDAHO,Jerome,12231.0,21,19,2
1747,IDAHO,Kellogg,2130.0,9,8,1
1748,IDAHO,Ketchum,2932.0,8,7,1
1749,IDAHO,Kimberly,4257.0,10,9,1
1750,IDAHO,Lewiston,33153.0,68,44,24
1751,IDAHO,Meridian,126744.0,157,120,37
1752,IDAHO,Middleton,9359.0,11,10,1
1753,IDAHO,Montpelier,2523.0,5,4,1
1754,IDAHO,Moscow,26368.0,43,35,8
1755,IDAHO,Mountain Home,14555.0,31,27,4
1756,IDAHO,Nampa,105619.0,200,140,60
1757,IDAHO,Orofino,3112.0,6,5,1
1758,IDAHO,Osburn,1571.0,2,2,0
1759,IDAHO,Parma,2145.0,5,4,1
1760,IDAHO,Payette,8065.0,16,14,2
1761,IDAHO,Pinehurst,1621.0,2,2,0
1762,IDAHO,Pocatello,57306.0,140,96,44
1763,IDAHO,Post Falls,40252.0,73,51,22
1764,IDAHO,Preston,5724.0,9,8,1
1765,IDAHO,Priest River,1950.0,6,5,1
1766,IDAHO,Rathdrum,9723.0,18,15,3
1767,IDAHO,Rexburg,30105.0,43,34,9
1768,IDAHO,Rigby,4482.0,9,8,1
1769,IDAHO,Rupert,5981.0,14,13,1
1770,IDAHO,Salmon,3185.0,9,9,0
1771,IDAHO,Sandpoint,9476.0,25,20,5
1772,IDAHO,Shelley,4674.0,9,9,0
1773,IDAHO,Soda Springs,2998.0,7,7,0
1774,IDAHO,Spirit Lake,2632.0,9,7,2
1775,IDAHO,St. Anthony,3601.0,6,6,0
1776,IDAHO,Sun Valley,1513.0,11,10,1
1777,IDAHO,Twin Falls,52158.0,97,73,24
1778,IDAHO,Weiser,5461.0,15,12,3
1779,IDAHO,Wilder,1843.0,5,5,0
1780,ILLINOIS,Addison,36149.0,127,67,60
1781,ILLINOIS,Albers,1109.0,2,1,1
1782,ILLINOIS,Algonquin,30796.0,54,46,8
1783,ILLINOIS,Alsip,18405.0,49,40,9
1784,ILLINOIS,Alton,25871.0,81,58,23
1785,ILLINOIS,Annawan,839.0,1,1,0
1786,ILLINOIS,Arcola,2831.0,7,6,1
1787,ILLINOIS,Arthur,2183.0,4,4,0
1788,ILLINOIS,Assumption,1045.0,2,2,0
1789,ILLINOIS,Bartonville,6009.0,17,12,5
1790,ILLINOIS,Bedford Park,608.0,39,37,2
1791,ILLINOIS,Blue Island,22509.0,47,38,9
1792,ILLINOIS,Bourbonnais,19442.0,27,25,2
1793,ILLINOIS,Bradley,15058.0,38,34,4
1794,ILLINOIS,Burbank,27836.0,58,40,18
1795,ILLINOIS,Campton Hills,11061.0,9,9,0
1796,ILLINOIS,Carbondale,24897.0,69,49,20
1797,ILLINOIS,Carlinville,5395.0,18,13,5
1798,ILLINOIS,Carlyle,3133.0,8,7,1
1799,ILLINOIS,Carthage,2401.0,4,4,0
1800,ILLINOIS,Charleston,19861.0,35,32,3
1801,ILLINOIS,Chenoa,3098.0,4,4,0
1802,ILLINOIS,Cherry Valley,2842.0,14,13,1
1803,ILLINOIS,Chicago Heights,28852.0,84,71,13
1804,ILLINOIS,Clarendon Hills,8745.0,13,12,1
1805,ILLINOIS,Colona,5039.0,14,12,2
1806,ILLINOIS,Countryside,5856.0,27,24,3
1807,ILLINOIS,Crete,7906.0,19,17,2
1808,ILLINOIS,Crystal Lake,39532.0,71,62,9
1809,ILLINOIS,Danville,29829.0,72,60,12
1810,ILLINOIS,Decatur,69426.0,149,138,11
1811,ILLINOIS,DeKalb,42475.0,78,61,17
1812,ILLINOIS,Des Plaines,58166.0,109,94,15
1813,ILLINOIS,Diamond,2479.0,4,4,0
1814,ILLINOIS,Downers Grove,48706.0,82,65,17
1815,ILLINOIS,East Hazel Crest,1472.0,11,9,2
1816,ILLINOIS,East Peoria,22235.0,47,43,4
1817,ILLINOIS,Evergreen Park,18813.0,72,54,18
1818,ILLINOIS,Farmer City,1895.0,4,4,0
1819,ILLINOIS,Flossmoor,8979.0,25,20,5
1820,ILLINOIS,Fox Lake,10386.0,32,26,6
1821,ILLINOIS,Galesburg,29576.0,75,49,26
1822,ILLINOIS,Geneseo,6494.0,20,14,6
1823,ILLINOIS,Geneva,21680.0,44,35,9
1824,ILLINOIS,Gibson City,3258.0,8,7,1
1825,ILLINOIS,Glen Carbon,12881.0,36,25,11
1826,ILLINOIS,Glendale Heights,33252.0,67,52,15
1827,ILLINOIS,Glenwood,8580.0,26,23,3
1828,ILLINOIS,Godley,790.0,4,4,0
1829,ILLINOIS,Greenfield,955.0,3,3,0
1830,ILLINOIS,Gurnee,30061.0,90,57,33
1831,ILLINOIS,Harvard,8935.0,18,16,2
1832,ILLINOIS,Havana,2912.0,15,9,6
1833,ILLINOIS,Hickory Hills,13506.0,39,28,11
1834,ILLINOIS,Highland,10022.0,26,20,6
1835,ILLINOIS,Highland Park,29392.0,65,55,10
1836,ILLINOIS,Homer Glen,24285.0,22,22,0
1837,ILLINOIS,Homewood,18393.0,46,41,5
1838,ILLINOIS,Hoopeston,4901.0,14,10,4
1839,ILLINOIS,Hudson,1807.0,2,2,0
1840,ILLINOIS,Itasca,9873.0,21,18,3
1841,ILLINOIS,Jacksonville,18398.0,45,41,4
1842,ILLINOIS,Joliet,146589.0,315,252,63
1843,ILLINOIS,Kankakee,25490.0,65,57,8
1844,ILLINOIS,Kenilworth,2436.0,9,8,1
1845,ILLINOIS,Kildeer,4002.0,10,8,2
1846,ILLINOIS,La Grange Park,12808.0,23,21,2
1847,ILLINOIS,Lake in the Hills,28284.0,47,39,8
1848,ILLINOIS,Lake Zurich,19764.0,50,31,19
1849,ILLINOIS,Lemont,17470.0,26,21,5
1850,ILLINOIS,Le Roy,3492.0,8,8,0
1851,ILLINOIS,Lincoln,13297.0,28,26,2
1852,ILLINOIS,Lisle,23208.0,45,35,10
1853,ILLINOIS,Livingston,791.0,1,1,0
1854,ILLINOIS,Loves Park,23323.0,42,40,2
1855,ILLINOIS,Lovington,1000.0,2,2,0
1856,ILLINOIS,Mackinaw,1853.0,2,2,0
1857,ILLINOIS,Manito,1450.0,3,3,0
1858,ILLINOIS,Maple Park,1392.0,1,1,0
1859,ILLINOIS,Marseilles,4748.0,10,9,1
1860,ILLINOIS,Mascoutah,8119.0,16,15,1
1861,ILLINOIS,McHenry,27106.0,77,47,30
1862,ILLINOIS,McLeansboro,2716.0,5,5,0
1863,ILLINOIS,Metropolis,5821.0,19,14,5
1864,ILLINOIS,Milledgeville,937.0,2,2,0
1865,ILLINOIS,Millstadt,3803.0,9,9,0
1866,ILLINOIS,Mokena,20194.0,34,31,3
1867,ILLINOIS,Morris,15321.0,29,25,4
1868,ILLINOIS,Morrison,3927.0,8,8,0
1869,ILLINOIS,Morton,16218.0,24,22,2
1870,ILLINOIS,Mount Carmel,6768.0,19,12,7
1871,ILLINOIS,Mount Prospect,53125.0,102,81,21
1872,ILLINOIS,Mount Pulaski,1438.0,2,2,0
1873,ILLINOIS,Mount Zion,5753.0,12,10,2
1874,ILLINOIS,New Lenox,27379.0,43,37,6
1875,ILLINOIS,Newman,833.0,1,1,0
1876,ILLINOIS,Niles,28493.0,66,52,14
1877,ILLINOIS,Normal,54636.0,76,68,8
1878,ILLINOIS,North Aurora,18302.0,33,31,2
1879,ILLINOIS,Northlake,11994.0,48,35,13
1880,ILLINOIS,North Pekin,1524.0,6,6,0
1881,ILLINOIS,Oakwood,1447.0,2,2,0
1882,ILLINOIS,O'Fallon,29688.0,65,45,20
1883,ILLINOIS,Oswego,37362.0,62,51,11
1884,ILLINOIS,Ottawa,18017.0,50,35,15
1885,ILLINOIS,Palos Heights,12361.0,31,27,4
1886,ILLINOIS,Palos Hills,16813.0,32,29,3
1887,ILLINOIS,Palos Park,4704.0,12,11,1
1888,ILLINOIS,Pekin,31593.0,58,50,8
1889,ILLINOIS,Peoria,108891.0,216,196,20
1890,ILLINOIS,Pontiac,11106.0,21,19,2
1891,ILLINOIS,Princeton,7353.0,16,15,1
1892,ILLINOIS,Rantoul,12241.0,36,30,6
1893,ILLINOIS,Riverdale,12849.0,29,25,4
1894,ILLINOIS,River Forest,10647.0,26,24,2
1895,ILLINOIS,Rock Falls,8577.0,24,21,3
1896,ILLINOIS,Rockford,144027.0,325,282,43
1897,ILLINOIS,Rock Island,36666.0,108,81,27
1898,ILLINOIS,Rockton,7448.0,18,16,2
1899,ILLINOIS,Rossville,1189.0,3,3,0
1900,ILLINOIS,Roxana,1395.0,6,5,1
1901,ILLINOIS,Royalton,1106.0,3,3,0
1902,ILLINOIS,Salem,6904.0,26,18,8
1903,ILLINOIS,Sandwich,7381.0,18,15,3
1904,ILLINOIS,Skokie,62163.0,148,105,43
1905,ILLINOIS,Springfield,113331.0,239,216,23
1906,ILLINOIS,Spring Valley,5020.0,11,10,1
1907,ILLINOIS,St. Anne,1164.0,4,4,0
1908,ILLINOIS,Sugar Grove,9976.0,10,10,0
1909,ILLINOIS,Swansea,13245.0,23,21,2
1910,ILLINOIS,Sycamore,18399.0,33,30,3
1911,ILLINOIS,Thomson,544.0,1,1,0
1912,ILLINOIS,Thornton,2365.0,11,10,1
1913,ILLINOIS,Tilton,2649.0,6,6,0
1914,ILLINOIS,Troy,10447.0,25,19,6
1915,ILLINOIS,Tuscola,4359.0,8,7,1
1916,ILLINOIS,Vernon Hills,26569.0,64,40,24
1917,ILLINOIS,Watseka,4639.0,12,11,1
1918,ILLINOIS,West Chicago,26526.0,49,45,4
1919,ILLINOIS,West Dundee,8938.0,22,19,3
1920,ILLINOIS,Westmont,24224.0,47,41,6
1921,ILLINOIS,Westville,2886.0,3,3,0
1922,ILLINOIS,Wheeling,39087.0,90,60,30
1923,ILLINOIS,Wilmette,26793.0,59,45,14
1924,ILLINOIS,Winnetka,12192.0,31,26,5
1925,ILLINOIS,Wood Dale,13455.0,41,32,9
1926,ILLINOIS,Worth,10289.0,28,26,2
1927,INDIANA,Albion,2372.0,6,6,0
1928,INDIANA,Auburn,13700.0,27,26,1
1929,INDIANA,Avon,20055.0,35,33,2
1930,INDIANA,Bargersville,8933.0,15,14,1
1931,INDIANA,Batesville,6773.0,18,13,5
1932,INDIANA,Bluffton,10113.0,33,21,12
1933,INDIANA,Brownsburg,28227.0,57,50,7
1934,INDIANA,Cannelton,1464.0,4,4,0
1935,INDIANA,Cedar Lake,13806.0,24,22,2
1936,INDIANA,Columbia City,9479.0,33,22,11
1937,INDIANA,Columbus,48902.0,91,83,8
1938,INDIANA,Danville,10364.0,20,18,2
1939,INDIANA,Dyer,15914.0,35,32,3
1940,INDIANA,Edinburgh,4629.0,13,12,1
1941,INDIANA,Elwood,8357.0,19,18,1
1942,INDIANA,Fishers,99184.0,131,117,14
1943,INDIANA,Fort Wayne,274295.0,529,462,67
1944,INDIANA,Frankfort,15692.0,39,34,5
1945,INDIANA,Franklin,26091.0,60,53,7
1946,INDIANA,Goshen,34336.0,71,60,11
1947,INDIANA,Greenwood,61277.0,75,67,8
1948,INDIANA,Highland,22144.0,46,41,5
1949,INDIANA,Hobart,27777.0,77,66,11
1950,INDIANA,Huntington,17006.0,38,35,3
1951,INDIANA,Kendallville,9895.0,27,18,9
1952,INDIANA,Kokomo,58248.0,106,87,19
1953,INDIANA,Leavenworth,234.0,3,3,0
1954,INDIANA,Lebanon,16155.0,44,42,2
1955,INDIANA,Madison,11729.0,101,40,61
1956,INDIANA,Muncie,67262.0,102,94,8
1957,INDIANA,Munster,22377.0,45,40,5
1958,INDIANA,New Haven,16088.0,32,24,8
1959,INDIANA,New Whiteland,6443.0,8,7,1
1960,INDIANA,Noblesville,67290.0,106,96,10
1961,INDIANA,North Salem,542.0,1,1,0
1962,INDIANA,North Vernon,6594.0,20,17,3
1963,INDIANA,Pendleton,4459.0,12,11,1
1964,INDIANA,Peru,10877.0,27,24,3
1965,INDIANA,Pittsboro,3913.0,9,8,1
1966,INDIANA,Plainfield,37257.0,68,61,7
1967,INDIANA,Seymour,20302.0,62,43,19
1968,INDIANA,Shirley,911.0,2,2,0
1969,INDIANA,South Bend,101936.0,285,222,63
1970,INDIANA,St. John,20168.0,25,23,2
1971,INDIANA,Vincennes,16650.0,42,37,5
1972,INDIANA,Walkerton,2261.0,10,6,4
1973,INDIANA,West Lafayette,52675.0,60,40,20
1974,INDIANA,Westville,5840.0,5,5,0
1975,INDIANA,Whiteland,4753.0,13,12,1
1976,INDIANA,Whitestown,10738.0,30,28,2
1977,INDIANA,Whiting,4797.0,17,16,1
1978,IOWA,Adel,5845.0,11,10,1
1979,IOWA,Albia,3706.0,7,6,1
1980,IOWA,Algona,5340.0,14,10,4
1981,IOWA,Altoona,20064.0,39,36,3
1982,IOWA,Ames,67886.0,71,48,23
1983,IOWA,Anamosa,5545.0,9,8,1
1984,IOWA,Ankeny,73109.0,76,65,11
1985,IOWA,Asbury,5999.0,6,6,0
1986,IOWA,Atlantic,6457.0,13,12,1
1987,IOWA,Audubon,1852.0,3,3,0
1988,IOWA,Belle Plaine,2406.0,5,5,0
1989,IOWA,Belmond,2222.0,5,5,0
1990,IOWA,Bettendorf,37022.0,51,45,6
1991,IOWA,Bloomfield,2699.0,7,6,1
1992,IOWA,Boone,12383.0,18,17,1
1993,IOWA,Burlington,24417.0,53,47,6
1994,IOWA,Camanche,4360.0,9,9,0
1995,IOWA,Carlisle,4369.0,9,8,1
1996,IOWA,Carroll,9651.0,16,15,1
1997,IOWA,Carter Lake,3793.0,11,10,1
1998,IOWA,Cedar Rapids,134763.0,280,223,57
1999,IOWA,Centerville,5394.0,14,9,5
2000,IOWA,Charles City,7174.0,15,14,1
2001,IOWA,Clarinda,5346.0,11,10,1
2002,IOWA,Clarion,2662.0,7,6,1
2003,IOWA,Clear Lake,7492.0,22,15,7
2004,IOWA,Clinton,24865.0,52,46,6
2005,IOWA,Clive,17652.0,33,28,5
2006,IOWA,Colfax,2046.0,2,2,0
2007,IOWA,Coralville,22874.0,37,33,4
2008,IOWA,Council Bluffs,62202.0,141,119,22
2009,IOWA,Creston,7644.0,16,12,4
2010,IOWA,Davenport,102014.0,187,162,25
2011,IOWA,Dayton,776.0,1,1,0
2012,IOWA,Decorah,7422.0,14,13,1
2013,IOWA,Denison,8241.0,19,12,7
2014,IOWA,Denver,1891.0,3,3,0
2015,IOWA,Des Moines,213060.0,461,364,97
2016,IOWA,DeWitt,5212.0,10,9,1
2017,IOWA,Dubuque,57790.0,104,97,7
2018,IOWA,Durant,1856.0,4,4,0
2019,IOWA,Dyersville,4478.0,7,7,0
2020,IOWA,Dysart,1305.0,2,2,0
2021,IOWA,Eldora,2556.0,5,5,0
2022,IOWA,Eldridge,6998.0,9,8,1
2023,IOWA,Emmetsburg,3645.0,7,6,1
2024,IOWA,Estherville,5516.0,12,12,0
2025,IOWA,Evansdale,4732.0,9,8,1
2026,IOWA,Fairfield,10608.0,18,12,6
2027,IOWA,Fort Dodge,23788.0,42,39,3
2028,IOWA,Fort Madison,10185.0,20,18,2
2029,IOWA,Glenwood,5260.0,11,10,1
2030,IOWA,Gowrie,946.0,1,1,0
2031,IOWA,Grinnell,9084.0,16,14,2
2032,IOWA,Grundy Center,2666.0,5,5,0
2033,IOWA,Hampton,4132.0,8,7,1
2034,IOWA,Harlan,4767.0,9,8,1
2035,IOWA,Hawarden,2434.0,4,4,0
2036,IOWA,Hiawatha,7512.0,17,17,0
2037,IOWA,Huxley,4379.0,6,6,0
2038,IOWA,Independence,6227.0,12,11,1
2039,IOWA,Indianola,16203.0,27,23,4
2040,IOWA,Iowa City,77522.0,96,73,23
2041,IOWA,Iowa Falls,4907.0,13,8,5
2042,IOWA,Jefferson,4048.0,7,7,0
2043,IOWA,Johnston,23759.0,35,30,5
2044,IOWA,Keokuk,10025.0,25,22,3
2045,IOWA,Knoxville,7062.0,16,14,2
2046,IOWA,Lansing,926.0,3,3,0
2047,IOWA,Le Mars,10233.0,17,15,2
2048,IOWA,Leon,1793.0,2,2,0
2049,IOWA,Manchester,4987.0,17,10,7
2050,IOWA,Maquoketa,5894.0,18,11,7
2051,IOWA,Marengo,2460.0,3,3,0
2052,IOWA,Marion,41370.0,58,45,13
2053,IOWA,Mar-Mac,1268.0,2,2,0
2054,IOWA,Marshalltown,26651.0,42,37,5
2055,IOWA,Mason City,26550.0,47,40,7
2056,IOWA,Mechanicsville,1113.0,1,1,0
2057,IOWA,Monticello,3882.0,9,8,1
2058,IOWA,Mount Pleasant,8494.0,16,14,2
2059,IOWA,Mount Vernon-Lisbon,6794.0,9,8,1
2060,IOWA,Muscatine,23499.0,42,38,4
2061,IOWA,Nevada,6669.0,12,10,2
2062,IOWA,New Hampton,3365.0,6,6,0
2063,IOWA,Newton,15116.0,32,27,5
2064,IOWA,North Liberty,20482.0,23,21,2
2065,IOWA,Norwalk,12854.0,20,19,1
2066,IOWA,Oelwein,5731.0,12,10,2
2067,IOWA,Ogden,1980.0,3,3,0
2068,IOWA,Orange City,6280.0,7,7,0
2069,IOWA,Osage,3541.0,7,6,1
2070,IOWA,Osceola,5320.0,12,11,1
2071,IOWA,Oskaloosa,11832.0,17,15,2
2072,IOWA,Ottumwa,24308.0,50,40,10
2073,IOWA,Pella,10260.0,24,18,6
2074,IOWA,Perry,7912.0,18,12,6
2075,IOWA,Pleasant Hill,10153.0,22,20,2
2076,IOWA,Polk City,5350.0,8,8,0
2077,IOWA,Postville,2014.0,4,4,0
2078,IOWA,Preston,935.0,1,1,0
2079,IOWA,Princeton,962.0,1,1,0
2080,IOWA,Red Oak,5229.0,12,10,2
2081,IOWA,Rock Valley,3945.0,6,6,0
2082,IOWA,Sabula,541.0,1,1,0
2083,IOWA,Sac City,2018.0,4,4,0
2084,IOWA,Sergeant Bluff,5207.0,9,8,1
2085,IOWA,Sheldon,5058.0,7,7,0
2086,IOWA,Shenandoah,4749.0,9,8,1
2087,IOWA,Sigourney,1972.0,2,1,1
2088,IOWA,Sioux Center,7729.0,8,8,0
2089,IOWA,Sioux City,82750.0,148,128,20
2090,IOWA,Spencer,10966.0,28,20,8
2091,IOWA,Spirit Lake,5292.0,10,9,1
2092,IOWA,Storm Lake,10414.0,23,19,4
2093,IOWA,Story City,3320.0,6,6,0
2094,IOWA,Tama,2709.0,6,6,0
2095,IOWA,Tipton,3174.0,7,6,1
2096,IOWA,Toledo,2106.0,6,6,0
2097,IOWA,University Heights,1024.0,5,5,0
2098,IOWA,Urbandale,45201.0,61,52,9
2099,IOWA,Vinton,4996.0,11,9,2
2100,IOWA,Washington,7201.0,12,11,1
2101,IOWA,Waterloo,67174.0,121,113,8
2102,IOWA,Waukee,27858.0,32,29,3
2103,IOWA,Waukon,3570.0,7,6,1
2104,IOWA,Waverly,10340.0,17,16,1
2105,IOWA,Webster City,7608.0,20,13,7
2106,IOWA,West Branch,2539.0,4,4,0
2107,IOWA,West Burlington,2863.0,10,10,0
2108,IOWA,West Des Moines,70414.0,101,89,12
2109,IOWA,West Union,2249.0,5,5,0
2110,IOWA,Williamsburg,3191.0,6,6,0
2111,IOWA,Windsor Heights,4717.0,14,13,1
2112,IOWA,Winterset,5450.0,8,8,0
2113,KANSAS,Abilene,6055.0,16,13,3
2114,KANSAS,Andover,13871.0,32,24,8
2115,KANSAS,Anthony,2011.0,4,3,1
2116,KANSAS,Arkansas City,11531.0,42,22,20
2117,KANSAS,Arma,1405.0,6,6,0
2118,KANSAS,Atchison,10374.0,25,24,1
2119,KANSAS,Attica,540.0,1,1,0
2120,KANSAS,Atwood,1210.0,3,3,0
2121,KANSAS,Augusta,9290.0,30,22,8
2122,KANSAS,Baldwin City,4706.0,12,10,2
2123,KANSAS,Baxter Springs,3859.0,11,9,2
2124,KANSAS,Bel Aire,8660.0,17,15,2
2125,KANSAS,Belle Plaine,1522.0,4,4,0
2126,KANSAS,Belleville,1828.0,5,5,0
2127,KANSAS,Beloit,3540.0,8,7,1
2128,KANSAS,Benton,863.0,2,2,0
2129,KANSAS,Blue Rapids,954.0,2,2,0
2130,KANSAS,Bonner Springs,8072.0,26,23,3
2131,KANSAS,Buhler,1263.0,3,3,0
2132,KANSAS,Burlingame,879.0,2,2,0
2133,KANSAS,Burlington,2533.0,9,7,2
2134,KANSAS,Burrton,849.0,6,2,4
2135,KANSAS,Caldwell,963.0,3,3,0
2136,KANSAS,Caney,1924.0,11,6,5
2137,KANSAS,Canton,682.0,1,1,0
2138,KANSAS,Carbondale,1339.0,3,3,0
2139,KANSAS,Chanute,8979.0,20,17,3
2140,KANSAS,Chapman,1314.0,2,2,0
2141,KANSAS,Cheney,2180.0,5,5,0
2142,KANSAS,Cherokee,712.0,1,1,0
2143,KANSAS,Cherryvale,2098.0,7,6,1
2144,KANSAS,Claflin,589.0,1,1,0
2145,KANSAS,Clay Center,3957.0,8,7,1
2146,KANSAS,Clearwater,2589.0,6,6,0
2147,KANSAS,Coffeyville,9066.0,32,23,9
2148,KANSAS,Colby,5305.0,12,11,1
2149,KANSAS,Coldwater,725.0,1,1,0
2150,KANSAS,Columbus,2978.0,9,9,0
2151,KANSAS,Colwich,1509.0,3,3,0
2152,KANSAS,Conway Springs,1208.0,3,3,0
2153,KANSAS,Council Grove,2090.0,8,7,1
2154,KANSAS,Derby,25425.0,59,49,10
2155,KANSAS,Dodge City,26612.0,57,39,18
2156,KANSAS,Eastborough,727.0,6,6,0
2157,KANSAS,Edwardsville,4540.0,19,18,1
2158,KANSAS,El Dorado,12819.0,28,25,3
2159,KANSAS,Elkhart,1685.0,2,2,0
2160,KANSAS,Ellis,2013.0,5,5,0
2161,KANSAS,Elwood,1171.0,3,3,0
2162,KANSAS,Emporia,24462.0,46,40,6
2163,KANSAS,Eudora,6418.0,14,14,0
2164,KANSAS,Fairway,3972.0,10,9,1
2165,KANSAS,Fort Scott,7607.0,21,20,1
2166,KANSAS,Fredonia,2154.0,7,6,1
2167,KANSAS,Frontenac,3387.0,10,7,3
2168,KANSAS,Galena,2798.0,9,7,2
2169,KANSAS,Garden City,25920.0,89,60,29
2170,KANSAS,Garden Plain,919.0,2,2,0
2171,KANSAS,Gardner,22714.0,39,34,5
2172,KANSAS,Garnett,3243.0,7,7,0
2173,KANSAS,Girard,2644.0,8,6,2
2174,KANSAS,Goddard,5020.0,12,11,1
2175,KANSAS,Goodland,4283.0,11,9,2
2176,KANSAS,Grandview Plaza,1532.0,7,6,1
2177,KANSAS,Great Bend,14795.0,34,30,4
2178,KANSAS,Greensburg,777.0,2,2,0
2179,KANSAS,Halstead,2022.0,6,5,1
2180,KANSAS,Haven,1178.0,3,3,0
2181,KANSAS,Hays,20861.0,49,31,18
2182,KANSAS,Haysville,11445.0,29,25,4
2183,KANSAS,Herington,2213.0,5,5,0
2184,KANSAS,Hesston,3738.0,7,6,1
2185,KANSAS,Hiawatha,3075.0,11,10,1
2186,KANSAS,Highland,983.0,1,1,0
2187,KANSAS,Hill City,1343.0,4,4,0
2188,KANSAS,Hoisington,2429.0,7,6,1
2189,KANSAS,Holcomb,2037.0,3,3,0
2190,KANSAS,Holton,3193.0,11,7,4
2191,KANSAS,Horton,1659.0,8,4,4
2192,KANSAS,Hoxie,1191.0,2,2,0
2193,KANSAS,Hugoton,3653.0,7,6,1
2194,KANSAS,Humboldt,1762.0,7,5,2
2195,KANSAS,Hutchinson,40015.0,91,67,24
2196,KANSAS,Independence,8326.0,24,18,6
2197,KANSAS,Inman,1318.0,4,4,0
2198,KANSAS,Iola,5222.0,18,17,1
2199,KANSAS,Junction City,21680.0,67,47,20
2200,KANSAS,Kechi,2129.0,5,5,0
2201,KANSAS,Kingman,2727.0,19,8,11
2202,KANSAS,Kiowa,907.0,1,1,0
2203,KANSAS,La Cygne,1104.0,2,2,0
2204,KANSAS,La Harpe,527.0,1,1,0
2205,KANSAS,Lake Quivira,932.0,1,1,0
2206,KANSAS,Lansing,12021.0,19,18,1
2207,KANSAS,Larned,3591.0,7,7,0
2208,KANSAS,Lawrence,99530.0,160,136,24
2209,KANSAS,Leavenworth,35990.0,73,53,20
2210,KANSAS,Leawood,34957.0,74,54,20
2211,KANSAS,Lebo,878.0,4,4,0
2212,KANSAS,Lenexa,57012.0,130,81,49
2213,KANSAS,Liberal,18658.0,44,32,12
2214,KANSAS,Lindsborg,3259.0,8,7,1
2215,KANSAS,Louisburg,4619.0,11,10,1
2216,KANSAS,Lyndon,1009.0,1,1,0
2217,KANSAS,Lyons,3403.0,7,6,1
2218,KANSAS,Macksville,515.0,1,1,0
2219,KANSAS,Maize,5491.0,14,13,1
2220,KANSAS,Marion,1721.0,5,5,0
2221,KANSAS,Marysville,3246.0,8,7,1
2222,KANSAS,McLouth,833.0,2,2,0
2223,KANSAS,McPherson,13002.0,39,34,5
2224,KANSAS,Medicine Lodge,1784.0,5,5,0
2225,KANSAS,Merriam,11138.0,36,32,4
2226,KANSAS,Minneapolis,1883.0,4,4,0
2227,KANSAS,Mission,9931.0,30,26,4
2228,KANSAS,Moran,504.0,1,1,0
2229,KANSAS,Mound City,670.0,1,1,0
2230,KANSAS,Moundridge,1860.0,3,3,0
2231,KANSAS,Mount Hope,805.0,2,2,0
2232,KANSAS,Mulberry,521.0,1,1,0
2233,KANSAS,Mulvane,6610.0,14,14,0
2234,KANSAS,Neodesha,2186.0,9,7,2
2235,KANSAS,North Newton,1761.0,4,4,0
2236,KANSAS,Norton,2692.0,7,6,1
2237,KANSAS,Oakley,2028.0,10,6,4
2238,KANSAS,Oberlin,1658.0,4,4,0
2239,KANSAS,Onaga,677.0,1,1,0
2240,KANSAS,Osage City,2748.0,7,7,0
2241,KANSAS,Osborne,1266.0,3,3,0
2242,KANSAS,Oswego,1668.0,5,5,0
2243,KANSAS,Ottawa,12303.0,36,31,5
2244,KANSAS,Overland Park,199881.0,318,251,67
2245,KANSAS,Paola,5668.0,19,14,5
2246,KANSAS,Park City,8006.0,18,16,2
2247,KANSAS,Parsons,9368.0,24,16,8
2248,KANSAS,Peabody,1067.0,5,3,2
2249,KANSAS,Pittsburg,19939.0,59,44,15
2250,KANSAS,Plainville,1755.0,5,5,0
2251,KANSAS,Pleasanton,1154.0,2,2,0
2252,KANSAS,Prairie Village,22402.0,51,41,10
2253,KANSAS,Pratt,6428.0,23,15,8
2254,KANSAS,Protection,455.0,1,1,0
2255,KANSAS,Roeland Park,6644.0,14,12,2
2256,KANSAS,Rose Hill,3983.0,9,8,1
2257,KANSAS,Rossville,1110.0,2,2,0
2258,KANSAS,Russell,4369.0,14,8,6
2259,KANSAS,Sabetha,2552.0,9,5,4
2260,KANSAS,Salina,46112.0,97,76,21
2261,KANSAS,Scott City,3726.0,12,7,5
2262,KANSAS,Scranton,667.0,1,1,0
2263,KANSAS,Sedan,980.0,2,2,0
2264,KANSAS,Seneca,2087.0,4,4,0
2265,KANSAS,Shawnee,66710.0,112,90,22
2266,KANSAS,Smith Center,1542.0,2,2,0
2267,KANSAS,South Hutchinson,2498.0,6,6,0
2268,KANSAS,Spearville,765.0,1,1,0
2269,KANSAS,Spring Hill,8167.0,15,14,1
2270,KANSAS,Stafford,909.0,3,3,0
2271,KANSAS,Sterling,2160.0,5,5,0
2272,KANSAS,St. George,1066.0,2,1,1
2273,KANSAS,St. John,1125.0,3,3,0
2274,KANSAS,St. Marys,2649.0,6,6,0
2275,KANSAS,Tonganoxie,5761.0,14,13,1
2276,KANSAS,Topeka,124227.0,318,263,55
2277,KANSAS,Troy,940.0,1,1,0
2278,KANSAS,Udall,696.0,3,3,0
2279,KANSAS,Ulysses,5489.0,10,10,0
2280,KANSAS,Valley Center,7443.0,18,16,2
2281,KANSAS,Valley Falls,1149.0,3,3,0
2282,KANSAS,Victoria,1215.0,2,2,0
2283,KANSAS,WaKeeney,1724.0,5,5,0
2284,KANSAS,Wamego,4750.0,9,8,1
2285,KANSAS,Waterville,628.0,1,1,0
2286,KANSAS,Wathena,1264.0,2,2,0
2287,KANSAS,Wellington,7491.0,20,17,3
2288,KANSAS,Wellsville,1777.0,6,5,1
2289,KANSAS,Westwood,1657.0,8,7,1
2290,KANSAS,Wilson,707.0,7,6,1
2291,KANSAS,Winfield,11756.0,29,24,5
2292,KANSAS,Yates Center,1253.0,3,3,0
2293,KENTUCKY,Adairville,893.0,1,1,0
2294,KENTUCKY,Alexandria,9949.0,20,16,4
2295,KENTUCKY,Anchorage,2435.0,14,10,4
2296,KENTUCKY,Ashland,19913.0,50,46,4
2297,KENTUCKY,Bancroft,513.0,1,1,0
2298,KENTUCKY,Bardstown,13378.0,32,29,3
2299,KENTUCKY,Beaver Dam,3558.0,7,7,0
2300,KENTUCKY,Bellevue,5748.0,12,11,1
2301,KENTUCKY,Benton,4461.0,8,8,0
2302,KENTUCKY,Berea,16576.0,37,34,3
2303,KENTUCKY,Bloomfield,1088.0,1,1,0
2304,KENTUCKY,Bowling Green,71826.0,160,121,39
2305,KENTUCKY,Brandenburg,2897.0,5,5,0
2306,KENTUCKY,Brownsville,839.0,2,2,0
2307,KENTUCKY,Burgin,997.0,1,1,0
2308,KENTUCKY,Burkesville,1427.0,6,6,0
2309,KENTUCKY,Burnside,792.0,4,4,0
2310,KENTUCKY,Butler,576.0,1,1,0
2311,KENTUCKY,Calvert City,2502.0,8,7,1
2312,KENTUCKY,Campbellsville,11500.0,15,13,2
2313,KENTUCKY,Carlisle,2056.0,10,6,4
2314,KENTUCKY,Carrollton,3794.0,14,13,1
2315,KENTUCKY,Catlettsburg,1724.0,5,5,0
2316,KENTUCKY,Cave City,2437.0,9,9,0
2317,KENTUCKY,Centertown,429.0,1,1,0
2318,KENTUCKY,Central City,5664.0,11,11,0
2319,KENTUCKY,Clay,1083.0,1,1,0
2320,KENTUCKY,Cloverport,1151.0,1,1,0
2321,KENTUCKY,Coal Run Village,1475.0,6,3,3
2322,KENTUCKY,Cold Spring,6697.0,13,13,0
2323,KENTUCKY,Columbia,4937.0,14,14,0
2324,KENTUCKY,Corbin,7126.0,30,24,6
2325,KENTUCKY,Covington,40298.0,131,109,22
2326,KENTUCKY,Cynthiana,6294.0,19,18,1
2327,KENTUCKY,Danville,17042.0,38,36,2
2328,KENTUCKY,Dayton,5678.0,12,11,1
2329,KENTUCKY,Eddyville,2549.0,3,3,0
2330,KENTUCKY,Edgewood,8796.0,17,17,0
2331,KENTUCKY,Edmonton,1595.0,6,6,0
2332,KENTUCKY,Elizabethtown,30530.0,81,63,18
2333,KENTUCKY,Elkhorn City,862.0,1,1,0
2334,KENTUCKY,Elkton,2158.0,8,7,1
2335,KENTUCKY,Elsmere,8672.0,15,15,0
2336,KENTUCKY,Eminence,2574.0,8,8,0
2337,KENTUCKY,Erlanger,23678.0,46,43,3
2338,KENTUCKY,Falmouth,2074.0,7,6,1
2339,KENTUCKY,Ferguson,945.0,1,1,0
2340,KENTUCKY,Flatwoods,7019.0,5,5,0
2341,KENTUCKY,Fleming-Neon,601.0,2,2,0
2342,KENTUCKY,Flemingsburg,2800.0,11,11,0
2343,KENTUCKY,Florence,33824.0,70,67,3
2344,KENTUCKY,Fort Mitchell,8273.0,13,13,0
2345,KENTUCKY,Fort Thomas,16269.0,23,22,1
2346,KENTUCKY,Fort Wright,5787.0,14,14,0
2347,KENTUCKY,Fountain Run,207.0,1,1,0
2348,KENTUCKY,Frankfort,27753.0,77,59,18
2349,KENTUCKY,Franklin,9105.0,22,21,1
2350,KENTUCKY,Fulton,2077.0,9,9,0
2351,KENTUCKY,Georgetown,36590.0,91,64,27
2352,KENTUCKY,Glasgow,14452.0,42,34,8
2353,KENTUCKY,Graymoor-Devondale,3098.0,15,15,0
2354,KENTUCKY,Grayson,3808.0,13,12,1
2355,KENTUCKY,Greensburg,2048.0,6,6,0
2356,KENTUCKY,Greenville,4122.0,11,11,0
2357,KENTUCKY,Hardinsburg,2346.0,5,5,0
2358,KENTUCKY,Harlan,1447.0,12,10,2
2359,KENTUCKY,Harrodsburg,8560.0,21,18,3
2360,KENTUCKY,Hartford,2719.0,5,5,0
2361,KENTUCKY,Hazard,4721.0,26,18,8
2362,KENTUCKY,Highland Heights ,7023.0,11,10,1
2363,KENTUCKY,Hillview,9274.0,20,20,0
2364,KENTUCKY,Hodgenville,3257.0,8,7,1
2365,KENTUCKY,Hopkinsville,30787.0,98,68,30
2366,KENTUCKY,Horse Cave,2422.0,7,7,0
2367,KENTUCKY,Hustonville,367.0,1,1,0
2368,KENTUCKY,Hyden,319.0,1,1,0
2369,KENTUCKY,Independence,29339.0,37,35,2
2370,KENTUCKY,Indian Hills,2980.0,8,8,0
2371,KENTUCKY,Irvine,2271.0,7,7,0
2372,KENTUCKY,Jackson,1892.0,12,7,5
2373,KENTUCKY,Jamestown,1802.0,6,6,0
2374,KENTUCKY,Jeffersontown,27533.0,65,54,11
2375,KENTUCKY,Jenkins,1865.0,7,7,0
2376,KENTUCKY,Junction City,2347.0,2,2,0
2377,KENTUCKY,La Grange,9186.0,17,15,2
2378,KENTUCKY,Lakeside Park-Crestview Hills,6110.0,13,12,1
2379,KENTUCKY,Lancaster,3845.0,12,12,0
2380,KENTUCKY,Lawrenceburg,11581.0,22,14,8
2381,KENTUCKY,Lebanon,5751.0,27,17,10
2382,KENTUCKY,Leitchfield,6838.0,19,18,1
2383,KENTUCKY,Lewisburg,807.0,1,1,0
2384,KENTUCKY,Lexington,328965.0,635,521,114
2385,KENTUCKY,Louisa,2313.0,7,7,0
2386,KENTUCKY,Louisville Metro,678236.0,1320,1038,282
2387,KENTUCKY,Loyall,576.0,2,2,0
2388,KENTUCKY,Ludlow,4502.0,11,10,1
2389,KENTUCKY,Manchester,1261.0,12,12,0
2390,KENTUCKY,Mayfield,9648.0,24,23,1
2391,KENTUCKY,Maysville,8650.0,36,26,10
2392,KENTUCKY,Middlesboro,8762.0,28,24,4
2393,KENTUCKY,Middletown,7930.0,18,17,1
2394,KENTUCKY,Millersburg,785.0,2,2,0
2395,KENTUCKY,Monticello,5880.0,11,9,2
2396,KENTUCKY,Morehead,7673.0,27,19,8
2397,KENTUCKY,Mount Sterling,7281.0,23,21,2
2398,KENTUCKY,Mount Vernon,2366.0,7,7,0
2399,KENTUCKY,Mount Washington,15048.0,22,21,1
2400,KENTUCKY,Muldraugh,985.0,3,3,0
2401,KENTUCKY,Munfordville,1665.0,5,5,0
2402,KENTUCKY,Murray,19605.0,43,36,7
2403,KENTUCKY,Newport,14851.0,47,43,4
2404,KENTUCKY,Nicholasville,31184.0,68,60,8
2405,KENTUCKY,Oak Grove,7355.0,16,16,0
2406,KENTUCKY,Olive Hill,1524.0,8,8,0
2407,KENTUCKY,Owensboro,60636.0,132,97,35
2408,KENTUCKY,Owenton,1546.0,5,3,2
2409,KENTUCKY,Owingsville,1569.0,5,5,0
2410,KENTUCKY,Paducah,24873.0,104,77,27
2411,KENTUCKY,Paintsville,3897.0,9,9,0
2412,KENTUCKY,Park Hills,2996.0,8,8,0
2413,KENTUCKY,Pewee Valley,1588.0,1,1,0
2414,KENTUCKY,Pikeville,6378.0,26,25,1
2415,KENTUCKY,Pineville,1670.0,7,7,0
2416,KENTUCKY,Pioneer Village,3003.0,5,5,0
2417,KENTUCKY,Pippa Passes,611.0,1,1,0
2418,KENTUCKY,Powderly,736.0,23,9,14
2419,KENTUCKY,Prestonsburg,3424.0,24,16,8
2420,KENTUCKY,Princeton,6036.0,15,14,1
2421,KENTUCKY,Prospect,4941.0,8,7,1
2422,KENTUCKY,Radcliff,22957.0,44,28,16
2423,KENTUCKY,Ravenna,552.0,1,1,0
2424,KENTUCKY,Richmond,37354.0,68,58,10
2425,KENTUCKY,Russell Springs,2671.0,8,7,1
2426,KENTUCKY,Russellville,7190.0,19,18,1
2427,KENTUCKY,Science Hill,693.0,3,3,0
2428,KENTUCKY,Scottsville,4579.0,29,19,10
2429,KENTUCKY,Shelbyville,17065.0,35,33,2
2430,KENTUCKY,Shepherdsville,12416.0,39,37,2
2431,KENTUCKY,Shively,15732.0,37,31,6
2432,KENTUCKY,Simpsonville,3014.0,9,9,0
2433,KENTUCKY,Smiths Grove,827.0,2,2,0
2434,KENTUCKY,Somerset,11889.0,50,45,5
2435,KENTUCKY,Southgate,4073.0,8,8,0
2436,KENTUCKY,Springfield,3006.0,16,9,7
2437,KENTUCKY,Stanton,2660.0,8,8,0
2438,KENTUCKY,St. Matthews,18038.0,46,39,7
2439,KENTUCKY,Taylor Mill,6837.0,12,11,1
2440,KENTUCKY,Taylorsville,1335.0,3,3,0
2441,KENTUCKY,Tompkinsville,2217.0,12,8,4
2442,KENTUCKY,Trenton,377.0,1,1,0
2443,KENTUCKY,Vanceburg,1392.0,6,6,0
2444,KENTUCKY,Versailles,27051.0,37,36,1
2445,KENTUCKY,Villa Hills,7498.0,14,14,0
2446,KENTUCKY,Vine Grove,6712.0,11,11,0
2447,KENTUCKY,Warsaw,1677.0,5,5,0
2448,KENTUCKY,West Buechel,1277.0,9,9,0
2449,KENTUCKY,West Point,870.0,1,1,0
2450,KENTUCKY,Whitesburg,1784.0,8,7,1
2451,KENTUCKY,Wilder,3063.0,9,9,0
2452,KENTUCKY,Williamsburg,5408.0,18,17,1
2453,KENTUCKY,Williamstown,3941.0,8,7,1
2454,KENTUCKY,Wilmore,6388.0,10,9,1
2455,KENTUCKY,Winchester,18689.0,53,37,16
2456,KENTUCKY,Woodlawn Park,970.0,1,1,0
2457,KENTUCKY,Worthington,1477.0,4,4,0
2458,LOUISIANA,Abbeville,11898.0,28,28,0
2459,LOUISIANA,Alexandria,45343.0,147,115,32
2460,LOUISIANA,Arnaudville,1040.0,7,3,4
2461,LOUISIANA,Baker,12931.0,33,26,7
2462,LOUISIANA,Baldwin,2124.0,1,1,0
2463,LOUISIANA,Ball,3896.0,14,12,2
2464,LOUISIANA,Basile,1788.0,8,7,1
2465,LOUISIANA,Bastrop,9543.0,18,18,0
2466,LOUISIANA,Baton Rouge,218060.0,575,575,0
2467,LOUISIANA,Bernice,1580.0,3,3,0
2468,LOUISIANA,Breaux Bridge,8038.0,15,14,1
2469,LOUISIANA,Broussard,13667.0,34,34,0
2470,LOUISIANA,Clinton,1472.0,8,8,0
2471,LOUISIANA,Coushatta,1691.0,7,6,1
2472,LOUISIANA,Covington,10746.0,40,36,4
2473,LOUISIANA,Crowley,12448.0,32,32,0
2474,LOUISIANA,Delcambre,1835.0,6,5,1
2475,LOUISIANA,De Quincy,2988.0,19,11,8
2476,LOUISIANA,De Ridder,10512.0,32,32,0
2477,LOUISIANA,Dixie Inn,265.0,1,1,0
2478,LOUISIANA,Dubach,895.0,2,2,0
2479,LOUISIANA,Epps,805.0,1,1,0
2480,LOUISIANA,Erath,2022.0,11,7,4
2481,LOUISIANA,Evergreen,285.0,1,1,0
2482,LOUISIANA,Farmerville,3621.0,14,14,0
2483,LOUISIANA,Ferriday,3159.0,12,12,0
2484,LOUISIANA,Fisher,215.0,1,1,0
2485,LOUISIANA,Florien,591.0,8,7,1
2486,LOUISIANA,Folsom,888.0,5,4,1
2487,LOUISIANA,Franklin,6482.0,24,16,8
2488,LOUISIANA,Franklinton,3630.0,23,19,4
2489,LOUISIANA,French Settlement,1239.0,4,4,0
2490,LOUISIANA,Georgetown,318.0,4,4,0
2491,LOUISIANA,Golden Meadow,1919.0,6,5,1
2492,LOUISIANA,Gonzales,11399.0,48,43,5
2493,LOUISIANA,Grambling,5125.0,16,10,6
2494,LOUISIANA,Gramercy,3160.0,8,8,0
2495,LOUISIANA,Greenwood,3074.0,4,2,2
2496,LOUISIANA,Harahan,9243.0,27,21,6
2497,LOUISIANA,Haughton,3222.0,13,13,0
2498,LOUISIANA,Haynesville,1970.0,6,5,1
2499,LOUISIANA,Heflin,222.0,1,1,0
2500,LOUISIANA,Ida,207.0,2,1,1
2501,LOUISIANA,Independence,1935.0,7,7,0
2502,LOUISIANA,Iowa,3121.0,21,19,2
2503,LOUISIANA,Jennings,9592.0,26,21,5
2504,LOUISIANA,Kaplan,4320.0,12,12,0
2505,LOUISIANA,Kenner,66250.0,203,140,63
2506,LOUISIANA,Kinder,2310.0,14,11,3
2507,LOUISIANA,Krotz Springs,1153.0,8,5,3
2508,LOUISIANA,Leesville,5430.0,22,21,1
2509,LOUISIANA,Livingston,2028.0,6,6,0
2510,LOUISIANA,Livonia,1394.0,7,5,2
2511,LOUISIANA,Lockport,2372.0,5,5,0
2512,LOUISIANA,Mamou,3059.0,19,11,8
2513,LOUISIANA,Mandeville,12602.0,53,40,13
2514,LOUISIANA,Marion,737.0,2,2,0
2515,LOUISIANA,Marksville,5230.0,23,17,6
2516,LOUISIANA,Minden,11436.0,30,29,1
2517,LOUISIANA,Montgomery,715.0,8,2,6
2518,LOUISIANA,Morgan City,10343.0,48,40,8
2519,LOUISIANA,Natchitoches,17063.0,48,48,0
2520,LOUISIANA,New Iberia,27788.0,67,54,13
2521,LOUISIANA,Oakdale,7474.0,14,14,0
2522,LOUISIANA,Oil City,953.0,4,4,0
2523,LOUISIANA,Palmetto,156.0,1,1,0
2524,LOUISIANA,Patterson,5616.0,27,27,0
2525,LOUISIANA,Plaquemine,6316.0,19,19,0
2526,LOUISIANA,Pollock,482.0,5,4,1
2527,LOUISIANA,Ponchatoula,7648.0,32,28,4
2528,LOUISIANA,Port Barre,2091.0,14,9,5
2529,LOUISIANA,Port Vincent,653.0,3,3,0
2530,LOUISIANA,Rayville,3411.0,13,9,4
2531,LOUISIANA,Richwood,3376.0,4,4,0
2532,LOUISIANA,Ruston,21888.0,47,34,13
2533,LOUISIANA,Springhill,4630.0,18,14,4
2534,LOUISIANA,St. Gabriel,7612.0,19,12,7
2535,LOUISIANA,St. Martinville,5635.0,20,16,4
2536,LOUISIANA,Tallulah,6382.0,13,9,4
2537,LOUISIANA,Thibodaux,14402.0,66,47,19
2538,LOUISIANA,Tickfaw,788.0,5,5,0
2539,LOUISIANA,Vidalia,3611.0,25,25,0
2540,LOUISIANA,Ville Platte,7010.0,14,13,1
2541,LOUISIANA,Vinton,3192.0,15,10,5
2542,LOUISIANA,Welsh,3192.0,12,8,4
2543,LOUISIANA,Westlake,4906.0,15,10,5
2544,LOUISIANA,Westwego,8274.0,40,37,3
2545,LOUISIANA,White Castle,1618.0,34,29,5
2546,LOUISIANA,Winnfield,4224.0,16,12,4
2547,LOUISIANA,Youngsville,16208.0,35,31,4
2548,LOUISIANA,Zachary,18774.0,41,41,0
2549,MAINE,Ashland,1206.0,4,4,0
2550,MAINE,Auburn,23446.0,59,53,6
2551,MAINE,Augusta,18713.0,57,44,13
2552,MAINE,Baileyville,1450.0,4,4,0
2553,MAINE,Bangor,31898.0,93,81,12
2554,MAINE,Bar Harbor,7752.0,28,19,9
2555,MAINE,Bath,8320.0,23,18,5
2556,MAINE,Belfast,6712.0,17,16,1
2557,MAINE,Berwick,8074.0,11,10,1
2558,MAINE,Biddeford,21523.0,81,55,26
2559,MAINE,Boothbay Harbor,2232.0,6,5,1
2560,MAINE,Brewer,8897.0,23,21,2
2561,MAINE,Bridgton,5539.0,9,8,1
2562,MAINE,Brunswick,20656.0,38,32,6
2563,MAINE,Bucksport,4917.0,14,10,4
2564,MAINE,Buxton,8402.0,14,8,6
2565,MAINE,Calais,3017.0,3,3,0
2566,MAINE,Camden,4802.0,13,11,2
2567,MAINE,Cape Elizabeth,9356.0,13,12,1
2568,MAINE,Caribou,7570.0,16,15,1
2569,MAINE,Carrabassett Valley,789.0,1,1,0
2570,MAINE,Clinton,3358.0,3,3,0
2571,MAINE,Cumberland,8415.0,15,13,2
2572,MAINE,Damariscotta,2153.0,6,5,1
2573,MAINE,Dexter,3685.0,6,6,0
2574,MAINE,Dover-Foxcroft,4073.0,6,6,0
2575,MAINE,East Millinocket,7139.0,9,9,0
2576,MAINE,Eastport,1270.0,2,2,0
2577,MAINE,Eliot,7212.0,8,7,1
2578,MAINE,Ellsworth,8302.0,23,20,3
2579,MAINE,Fairfield,6534.0,11,11,0
2580,MAINE,Falmouth,12573.0,29,20,9
2581,MAINE,Farmington,7621.0,10,9,1
2582,MAINE,Fort Fairfield,3258.0,3,3,0
2583,MAINE,Fort Kent,3778.0,9,5,4
2584,MAINE,Freeport,8713.0,18,16,2
2585,MAINE,Fryeburg,3435.0,3,3,0
2586,MAINE,Gardiner,5675.0,11,10,1
2587,MAINE,Gorham,18130.0,25,22,3
2588,MAINE,Gouldsboro,1744.0,2,2,0
2589,MAINE,Greenville,1626.0,3,3,0
2590,MAINE,Hallowell,2386.0,5,5,0
2591,MAINE,Hampden,7537.0,12,12,0
2592,MAINE,Holden,3124.0,6,6,0
2593,MAINE,Houlton,5732.0,17,12,5
2594,MAINE,Islesboro,562.0,1,1,0
2595,MAINE,Jay,4575.0,9,8,1
2596,MAINE,Kennebunk,11799.0,25,23,2
2597,MAINE,Kennebunkport,3692.0,19,14,5
2598,MAINE,Kittery,9915.0,29,23,6
2599,MAINE,Lewiston,36191.0,92,79,13
2600,MAINE,Limestone,2150.0,3,3,0
2601,MAINE,Lincoln,4862.0,11,9,2
2602,MAINE,Lisbon,9057.0,19,13,6
2603,MAINE,Livermore Falls,3178.0,6,6,0
2604,MAINE,Madawaska,3686.0,5,5,0
2605,MAINE,Mechanic Falls,2977.0,2,2,0
2606,MAINE,Mexico,2631.0,4,4,0
2607,MAINE,Milbridge,1296.0,1,1,0
2608,MAINE,Milo,2311.0,4,3,1
2609,MAINE,Monmouth,4178.0,4,4,0
2610,MAINE,Newport,3245.0,6,6,0
2611,MAINE,North Berwick,4762.0,9,8,1
2612,MAINE,Norway,4988.0,10,9,1
2613,MAINE,Oakland,6351.0,10,9,1
2614,MAINE,Ogunquit,938.0,12,11,1
2615,MAINE,Old Orchard Beach,9145.0,24,22,2
2616,MAINE,Old Town,7362.0,15,14,1
2617,MAINE,Orono,10666.0,13,12,1
2618,MAINE,Oxford,4102.0,10,9,1
2619,MAINE,Paris,5161.0,9,8,1
2620,MAINE,Phippsburg,2281.0,1,1,0
2621,MAINE,Pittsfield,3982.0,8,7,1
2622,MAINE,Portland,66875.0,203,146,57
2623,MAINE,Presque Isle,8882.0,21,16,5
2624,MAINE,Rangeley,1149.0,2,2,0
2625,MAINE,Richmond,3493.0,6,6,0
2626,MAINE,Rockland,7172.0,17,15,2
2627,MAINE,Rockport,3395.0,5,5,0
2628,MAINE,Rumford,5726.0,15,13,2
2629,MAINE,Sabattus,5077.0,6,5,1
2630,MAINE,Saco,20290.0,46,33,13
2631,MAINE,Sanford,21300.0,42,38,4
2632,MAINE,Scarborough,21810.0,57,37,20
2633,MAINE,Searsport,2635.0,4,4,0
2634,MAINE,Skowhegan,8205.0,18,16,2
2635,MAINE,South Berwick,7654.0,11,10,1
2636,MAINE,South Portland,26048.0,57,49,8
2637,MAINE,Southwest Harbor,1796.0,9,5,4
2638,MAINE,Thomaston,2761.0,6,6,0
2639,MAINE,Topsham,8960.0,17,15,2
2640,MAINE,Veazie,1815.0,4,4,0
2641,MAINE,Waldoboro,5079.0,6,6,0
2642,MAINE,Washburn,1519.0,3,3,0
2643,MAINE,Waterville,16667.0,40,30,10
2644,MAINE,Wells,10950.0,33,24,9
2645,MAINE,Westbrook,19451.0,45,40,5
2646,MAINE,Wilton,3912.0,4,4,0
2647,MAINE,Windham,19118.0,31,29,2
2648,MAINE,Winslow,7641.0,12,11,1
2649,MAINE,Winter Harbor,510.0,1,1,0
2650,MAINE,Winthrop,6023.0,13,8,5
2651,MAINE,Wiscasset,3750.0,5,4,1
2652,MAINE,Yarmouth,8628.0,14,13,1
2653,MAINE,York,13413.0,36,25,11
2654,MARYLAND,Aberdeen,16067.0,50,35,15
2655,MARYLAND,Annapolis,39638.0,143,112,31
2656,MARYLAND,Baltimore,590536.0,2843,2360,483
2657,MARYLAND,Baltimore City Sheriff,,176,131,45
2658,MARYLAND,Bel Air,10278.0,41,31,10
2659,MARYLAND,Berlin,4993.0,18,13,5
2660,MARYLAND,Berwyn Heights,3261.0,9,8,1
2661,MARYLAND,Boonsboro,3676.0,5,4,1
2662,MARYLAND,Bowie,58546.0,80,61,19
2663,MARYLAND,Brentwood,3451.0,6,5,1
2664,MARYLAND,Cambridge,12189.0,37,33,4
2665,MARYLAND,Capitol Heights,4535.0,13,11,2
2666,MARYLAND,Centreville,5025.0,15,13,2
2667,MARYLAND,Chestertown,4974.0,9,8,1
2668,MARYLAND,Cheverly,6441.0,13,11,2
2669,MARYLAND,Chevy Chase Village,2060.0,17,11,6
2670,MARYLAND,Colmar Manor,1463.0,4,3,1
2671,MARYLAND,Cottage City,1360.0,5,5,0
2672,MARYLAND,Crisfield,2517.0,14,11,3
2673,MARYLAND,Cumberland,18971.0,54,49,5
2674,MARYLAND,Delmar,3651.0,12,11,1
2675,MARYLAND,Denton,4553.0,10,9,1
2676,MARYLAND,District Heights,6002.0,11,7,4
2677,MARYLAND,Easton,16644.0,51,36,15
2678,MARYLAND,Edmonston,1496.0,4,3,1
2679,MARYLAND,Elkton,15684.0,46,40,6
2680,MARYLAND,Fairmount Heights,1530.0,1,1,0
2681,MARYLAND,Federalsburg,2650.0,10,9,1
2682,MARYLAND,Forest Heights,2566.0,16,12,4
2683,MARYLAND,Frederick,74138.0,180,139,41
2684,MARYLAND,Frostburg,8413.0,17,13,4
2685,MARYLAND,Fruitland,5375.0,24,19,5
2686,MARYLAND,Glenarden,6182.0,21,19,2
2687,MARYLAND,Greenbelt,23336.0,65,46,19
2688,MARYLAND,Greensboro,1875.0,4,4,0
2689,MARYLAND,Hagerstown,39942.0,103,81,22
2690,MARYLAND,Hampstead,6437.0,8,7,1
2691,MARYLAND,Hancock,1518.0,4,3,1
2692,MARYLAND,Havre de Grace,14263.0,42,32,10
2693,MARYLAND,Hurlock,1999.0,11,10,1
2694,MARYLAND,Hyattsville,18283.0,58,43,15
2695,MARYLAND,Landover Hills,1641.0,6,5,1
2696,MARYLAND,La Plata,9906.0,21,20,1
2697,MARYLAND,Laurel,25604.0,86,66,20
2698,MARYLAND,Manchester,4882.0,7,6,1
2699,MARYLAND,Morningside,1285.0,8,7,1
2700,MARYLAND,Mount Airy,9522.0,13,11,2
2701,MARYLAND,Mount Rainier,8146.0,19,17,2
2702,MARYLAND,New Carrollton,12965.0,27,20,7
2703,MARYLAND,North East,3616.0,11,10,1
2704,MARYLAND,Oakland,1794.0,2,2,0
2705,MARYLAND,Ocean City,6894.0,141,115,26
2706,MARYLAND,Ocean Pines,11696.0,18,14,4
2707,MARYLAND,Oxford,597.0,3,3,0
2708,MARYLAND,Perryville,4460.0,13,12,1
2709,MARYLAND,Pittsville,1481.0,1,1,0
2710,MARYLAND,Pocomoke City,4086.0,20,13,7
2711,MARYLAND,Princess Anne,3510.0,13,11,2
2712,MARYLAND,Ridgely,1657.0,5,5,0
2713,MARYLAND,Rising Sun,2783.0,4,4,0
2714,MARYLAND,Riverdale Park,7217.0,30,23,7
2715,MARYLAND,Rock Hall,1250.0,3,3,0
2716,MARYLAND,Salisbury,33294.0,112,83,29
2717,MARYLAND,Seat Pleasant,4757.0,39,31,8
2718,MARYLAND,Smithsburg,2966.0,5,4,1
2719,MARYLAND,Snow Hill,2039.0,7,7,0
2720,MARYLAND,St. Michaels,1029.0,10,9,1
2721,MARYLAND,Sykesville,3976.0,7,6,1
2722,MARYLAND,Takoma Park,17788.0,60,41,19
2723,MARYLAND,Taneytown,6855.0,16,14,2
2724,MARYLAND,Thurmont,7163.0,14,11,3
2725,MARYLAND,University Park,2635.0,8,7,1
2726,MARYLAND,Upper Marlboro,674.0,4,3,1
2727,MARYLAND,Westminster,18731.0,50,40,10
2728,MASSACHUSETTS,Acton,23853.0,51,40,11
2729,MASSACHUSETTS,Acushnet,10798.0,26,21,5
2730,MASSACHUSETTS,Agawam,28757.0,60,47,13
2731,MASSACHUSETTS,Amesbury,17809.0,39,33,6
2732,MASSACHUSETTS,Amherst,40843.0,46,43,3
2733,MASSACHUSETTS,Andover,37216.0,68,49,19
2734,MASSACHUSETTS,Aquinnah,328.0,4,4,0
2735,MASSACHUSETTS,Arlington,45767.0,73,60,13
2736,MASSACHUSETTS,Ashburnham,6429.0,17,12,5
2737,MASSACHUSETTS,Ashby,3242.0,7,6,1
2738,MASSACHUSETTS,Ashfield,1718.0,1,1,0
2739,MASSACHUSETTS,Ashland,18160.0,29,23,6
2740,MASSACHUSETTS,Attleboro,46007.0,85,70,15
2741,MASSACHUSETTS,Auburn,16885.0,48,37,11
2742,MASSACHUSETTS,Avon,4631.0,20,14,6
2743,MASSACHUSETTS,Ayer,8357.0,31,19,12
2744,MASSACHUSETTS,Barnstable,44841.0,130,106,24
2745,MASSACHUSETTS,Barre,5637.0,10,9,1
2746,MASSACHUSETTS,Becket,1700.0,5,5,0
2747,MASSACHUSETTS,Belchertown,15148.0,29,23,6
2748,MASSACHUSETTS,Bellingham,17634.0,39,30,9
2749,MASSACHUSETTS,Belmont,26206.0,56,44,12
2750,MASSACHUSETTS,Berkley,7007.0,9,9,0
2751,MASSACHUSETTS,Bernardston,2085.0,3,3,0
2752,MASSACHUSETTS,Beverly,42851.0,55,51,4
2753,MASSACHUSETTS,Billerica,43644.0,75,61,14
2754,MASSACHUSETTS,Blackstone,9304.0,22,18,4
2755,MASSACHUSETTS,Bolton,5579.0,13,12,1
2756,MASSACHUSETTS,Boston,704758.0,2716,2184,532
2757,MASSACHUSETTS,Boxborough,5880.0,19,13,6
2758,MASSACHUSETTS,Boxford,8436.0,12,12,0
2759,MASSACHUSETTS,Boylston,4806.0,15,11,4
2760,MASSACHUSETTS,Braintree,37643.0,102,84,18
2761,MASSACHUSETTS,Brewster,9843.0,27,22,5
2762,MASSACHUSETTS,Bridgewater,8446.0,44,40,4
2763,MASSACHUSETTS,Brockton,100516.0,220,192,28
2764,MASSACHUSETTS,Brookfield,3473.0,5,5,0
2765,MASSACHUSETTS,Brookline,59748.0,152,114,38
2766,MASSACHUSETTS,Buckland,1847.0,1,1,0
2767,MASSACHUSETTS,Burlington,29087.0,73,66,7
2768,MASSACHUSETTS,Cambridge,121699.0,303,262,41
2769,MASSACHUSETTS,Canton,24570.0,45,45,0
2770,MASSACHUSETTS,Carlisle,5312.0,15,10,5
2771,MASSACHUSETTS,Carver,12347.0,22,17,5
2772,MASSACHUSETTS,Charlton,13881.0,27,22,5
2773,MASSACHUSETTS,Chatham,6031.0,27,21,6
2774,MASSACHUSETTS,Chelmsford,35985.0,68,62,6
2775,MASSACHUSETTS,Chelsea,39971.0,112,104,8
2776,MASSACHUSETTS,Cheshire,3093.0,1,1,0
2777,MASSACHUSETTS,Chester,1382.0,1,1,0
2778,MASSACHUSETTS,Chicopee,55332.0,133,129,4
2779,MASSACHUSETTS,Cohasset,8738.0,21,20,1
2780,MASSACHUSETTS,Concord,19025.0,36,31,5
2781,MASSACHUSETTS,Dalton,6452.0,13,12,1
2782,MASSACHUSETTS,Danvers,27904.0,54,43,11
2783,MASSACHUSETTS,Dedham,25699.0,60,55,5
2784,MASSACHUSETTS,Deerfield,5041.0,12,11,1
2785,MASSACHUSETTS,Dennis,13971.0,54,45,9
2786,MASSACHUSETTS,Dighton,8207.0,21,16,5
2787,MASSACHUSETTS,Douglas,9259.0,20,15,5
2788,MASSACHUSETTS,Dover,6246.0,16,16,0
2789,MASSACHUSETTS,Dracut,31879.0,46,42,4
2790,MASSACHUSETTS,Dudley,11778.0,18,17,1
2791,MASSACHUSETTS,Dunstable,3454.0,10,9,1
2792,MASSACHUSETTS,Duxbury,16780.0,33,31,2
2793,MASSACHUSETTS,East Bridgewater,15324.0,30,23,7
2794,MASSACHUSETTS,Eastham,4937.0,22,17,5
2795,MASSACHUSETTS,Easthampton,15720.0,35,29,6
2796,MASSACHUSETTS,East Longmeadow,16286.0,29,26,3
2797,MASSACHUSETTS,Easton,25509.0,36,33,3
2798,MASSACHUSETTS,Edgartown,4470.0,21,19,2
2799,MASSACHUSETTS,Erving,1744.0,5,5,0
2800,MASSACHUSETTS,Essex,3888.0,10,9,1
2801,MASSACHUSETTS,Everett,46959.0,114,105,9
2802,MASSACHUSETTS,Fairhaven,16257.0,39,33,6
2803,MASSACHUSETTS,Fall River,90618.0,269,222,47
2804,MASSACHUSETTS,Falmouth,31320.0,58,54,4
2805,MASSACHUSETTS,Fitchburg,40626.0,92,76,16
2806,MASSACHUSETTS,Foxborough,18774.0,41,39,2
2807,MASSACHUSETTS,Framingham,75042.0,143,123,20
2808,MASSACHUSETTS,Franklin,35425.0,56,54,2
2809,MASSACHUSETTS,Freetown,9567.0,21,20,1
2810,MASSACHUSETTS,Gardner,20795.0,45,31,14
2811,MASSACHUSETTS,Georgetown,8920.0,18,13,5
2812,MASSACHUSETTS,Gill,1473.0,2,2,0
2813,MASSACHUSETTS,Gloucester,30963.0,69,62,7
2814,MASSACHUSETTS,Grafton,19347.0,24,20,4
2815,MASSACHUSETTS,Granby,6264.0,14,10,4
2816,MASSACHUSETTS,Great Barrington,6964.0,16,15,1
2817,MASSACHUSETTS,Groton,11407.0,26,20,6
2818,MASSACHUSETTS,Groveland,6967.0,12,10,2
2819,MASSACHUSETTS,Hadley,5335.0,20,14,6
2820,MASSACHUSETTS,Halifax,8275.0,13,12,1
2821,MASSACHUSETTS,Hamilton,8165.0,18,14,4
2822,MASSACHUSETTS,Hanover,15396.0,36,29,7
2823,MASSACHUSETTS,Hanson,11550.0,24,23,1
2824,MASSACHUSETTS,Hardwick,3077.0,6,6,0
2825,MASSACHUSETTS,Harwich,12235.0,40,33,7
2826,MASSACHUSETTS,Haverhill,64944.0,121,105,16
2827,MASSACHUSETTS,Hingham,26172.0,55,53,2
2828,MASSACHUSETTS,Hinsdale,1890.0,4,4,0
2829,MASSACHUSETTS,Holbrook,11163.0,27,26,1
2830,MASSACHUSETTS,Holden,19605.0,40,24,16
2831,MASSACHUSETTS,Holland,2493.0,2,2,0
2832,MASSACHUSETTS,Holliston,15138.0,30,25,5
2833,MASSACHUSETTS,Holyoke,40326.0,131,107,24
2834,MASSACHUSETTS,Hopedale,5985.0,17,13,4
2835,MASSACHUSETTS,Hopkinton,19192.0,34,24,10
2836,MASSACHUSETTS,Hudson,19954.0,45,34,11
2837,MASSACHUSETTS,Hull,11000.0,27,25,2
2838,MASSACHUSETTS,Ipswich,14297.0,29,25,4
2839,MASSACHUSETTS,Kingston,14843.0,31,23,8
2840,MASSACHUSETTS,Lakeville,12360.0,23,19,4
2841,MASSACHUSETTS,Lancaster,7900.0,10,8,2
2842,MASSACHUSETTS,Lanesboro,2909.0,6,6,0
2843,MASSACHUSETTS,Lawrence,81021.0,185,162,23
2844,MASSACHUSETTS,Leicester,11401.0,19,18,1
2845,MASSACHUSETTS,Lenox,4920.0,11,11,0
2846,MASSACHUSETTS,Leominster,41965.0,88,70,18
2847,MASSACHUSETTS,Leverett,1835.0,3,3,0
2848,MASSACHUSETTS,Lincoln,7114.0,19,13,6
2849,MASSACHUSETTS,Littleton,10480.0,28,20,8
2850,MASSACHUSETTS,Lowell,112230.0,306,236,70
2851,MASSACHUSETTS,Ludlow,21312.0,48,39,9
2852,MASSACHUSETTS,Lunenburg,12098.0,18,17,1
2853,MASSACHUSETTS,Lynn,95727.0,202,184,18
2854,MASSACHUSETTS,Lynnfield,13300.0,26,21,5
2855,MASSACHUSETTS,Malden,60433.0,109,99,10
2856,MASSACHUSETTS,Manchester-by-the-Sea,5513.0,32,26,6
2857,MASSACHUSETTS,Mansfield,24880.0,48,38,10
2858,MASSACHUSETTS,Marblehead,20791.0,40,30,10
2859,MASSACHUSETTS,Marion,5464.0,15,15,0
2860,MASSACHUSETTS,Marlborough,39682.0,81,70,11
2861,MASSACHUSETTS,Mashpee,14411.0,46,38,8
2862,MASSACHUSETTS,Mattapoisett,6772.0,21,21,0
2863,MASSACHUSETTS,Maynard,11508.0,27,21,6
2864,MASSACHUSETTS,Medfield,13266.0,24,18,6
2865,MASSACHUSETTS,Medway,13670.0,27,26,1
2866,MASSACHUSETTS,Melrose,28094.0,46,45,1
2867,MASSACHUSETTS,Mendon,6323.0,14,13,1
2868,MASSACHUSETTS,Methuen,51691.0,108,89,19
2869,MASSACHUSETTS,Middleboro,27228.0,48,43,5
2870,MASSACHUSETTS,Middleton,10311.0,18,17,1
2871,MASSACHUSETTS,Millbury,14160.0,26,21,5
2872,MASSACHUSETTS,Milton,27911.0,67,55,12
2873,MASSACHUSETTS,Montague,8178.0,22,17,5
2874,MASSACHUSETTS,Nahant,3544.0,13,12,1
2875,MASSACHUSETTS,Nantucket,11600.0,51,34,17
2876,MASSACHUSETTS,Natick,36340.0,73,57,16
2877,MASSACHUSETTS,Needham,32159.0,54,45,9
2878,MASSACHUSETTS,New Bedford,96346.0,271,234,37
2879,MASSACHUSETTS,Newburyport,18757.0,39,32,7
2880,MASSACHUSETTS,Newton,88769.0,171,140,31
2881,MASSACHUSETTS,Norfolk,12152.0,23,21,2
2882,MASSACHUSETTS,North Adams,12638.0,29,24,5
2883,MASSACHUSETTS,Northampton,28332.0,67,60,7
2884,MASSACHUSETTS,North Andover,32040.0,57,42,15
2885,MASSACHUSETTS,North Attleboro,29789.0,54,38,16
2886,MASSACHUSETTS,Northborough,15223.0,29,21,8
2887,MASSACHUSETTS,Northbridge,16850.0,27,19,8
2888,MASSACHUSETTS,Northfield,2951.0,3,3,0
2889,MASSACHUSETTS,North Reading,16134.0,33,30,3
2890,MASSACHUSETTS,Norton,20232.0,34,33,1
2891,MASSACHUSETTS,Norwell,11770.0,26,23,3
2892,MASSACHUSETTS,Norwood,30200.0,68,58,10
2893,MASSACHUSETTS,Oak Bluffs,4772.0,20,18,2
2894,MASSACHUSETTS,Oakham,1970.0,1,1,0
2895,MASSACHUSETTS,Orleans,5841.0,24,19,5
2896,MASSACHUSETTS,Oxford,14078.0,28,21,7
2897,MASSACHUSETTS,Palmer,12300.0,29,22,7
2898,MASSACHUSETTS,Paxton,5069.0,16,14,2
2899,MASSACHUSETTS,Peabody,53669.0,106,88,18
2900,MASSACHUSETTS,Pelham,1303.0,2,2,0
2901,MASSACHUSETTS,Pembroke,19505.0,32,30,2
2902,MASSACHUSETTS,Pepperell,12192.0,17,16,1
2903,MASSACHUSETTS,Plainville,9495.0,18,18,0
2904,MASSACHUSETTS,Plymouth,66289.0,131,109,22
2905,MASSACHUSETTS,Plympton,3157.0,9,8,1
2906,MASSACHUSETTS,Princeton,3522.0,7,6,1
2907,MASSACHUSETTS,Provincetown,2982.0,23,16,7
2908,MASSACHUSETTS,Quincy,95737.0,243,211,32
2909,MASSACHUSETTS,Randolph,32257.0,65,59,6
2910,MASSACHUSETTS,Raynham,14799.0,38,30,8
2911,MASSACHUSETTS,Reading,25900.0,59,44,15
2912,MASSACHUSETTS,Rehoboth,12697.0,35,29,6
2913,MASSACHUSETTS,Revere,52860.0,116,106,10
2914,MASSACHUSETTS,Rochester,6067.0,13,12,1
2915,MASSACHUSETTS,Rockland,18898.0,36,33,3
2916,MASSACHUSETTS,Rockport,7407.0,22,18,4
2917,MASSACHUSETTS,Rowley,6501.0,16,12,4
2918,MASSACHUSETTS,Salem,44120.0,95,85,10
2919,MASSACHUSETTS,Salisbury,9811.0,25,16,9
2920,MASSACHUSETTS,Sandwich,20266.0,44,34,10
2921,MASSACHUSETTS,Saugus,28967.0,84,69,15
2922,MASSACHUSETTS,Scituate,20046.0,38,36,2
2923,MASSACHUSETTS,Seekonk,16212.0,40,38,2
2924,MASSACHUSETTS,Sharon,19222.0,33,29,4
2925,MASSACHUSETTS,Sheffield,3098.0,4,4,0
2926,MASSACHUSETTS,Shelburne,1834.0,3,3,0
2927,MASSACHUSETTS,Sherborn,4445.0,15,15,0
2928,MASSACHUSETTS,Shirley,7641.0,14,12,2
2929,MASSACHUSETTS,Shrewsbury,39602.0,62,45,17
2930,MASSACHUSETTS,Somerset,18286.0,39,33,6
2931,MASSACHUSETTS,Southampton,6199.0,13,9,4
2932,MASSACHUSETTS,Southborough,10328.0,25,20,5
2933,MASSACHUSETTS,Southbridge,16932.0,50,38,12
2934,MASSACHUSETTS,South Hadley,17520.0,32,26,6
2935,MASSACHUSETTS,Southwick,9835.0,23,18,5
2936,MASSACHUSETTS,Spencer,12014.0,22,18,4
2937,MASSACHUSETTS,Springfield,154098.0,574,465,109
2938,MASSACHUSETTS,Sterling,8270.0,20,14,6
2939,MASSACHUSETTS,Stockbridge,1877.0,8,7,1
2940,MASSACHUSETTS,Stoneham,24439.0,47,39,8
2941,MASSACHUSETTS,Stoughton,29418.0,75,62,13
2942,MASSACHUSETTS,Stow,7294.0,13,11,2
2943,MASSACHUSETTS,Sturbridge,9670.0,27,20,7
2944,MASSACHUSETTS,Sudbury,19798.0,39,28,11
2945,MASSACHUSETTS,Sunderland,3628.0,6,5,1
2946,MASSACHUSETTS,Swampscott,15766.0,30,29,1
2947,MASSACHUSETTS,Swansea,17257.0,39,33,6
2948,MASSACHUSETTS,Taunton,58333.0,117,107,10
2949,MASSACHUSETTS,Templeton,8213.0,14,9,5
2950,MASSACHUSETTS,Tewksbury,31407.0,76,64,12
2951,MASSACHUSETTS,Tisbury,4198.0,16,13,3
2952,MASSACHUSETTS,Topsfield,6774.0,13,12,1
2953,MASSACHUSETTS,Townsend,9574.0,13,12,1
2954,MASSACHUSETTS,Truro,2024.0,17,12,5
2955,MASSACHUSETTS,Uxbridge,14561.0,28,22,6
2956,MASSACHUSETTS,Wakefield,27470.0,48,47,1
2957,MASSACHUSETTS,Walpole,27160.0,56,45,11
2958,MASSACHUSETTS,Waltham,62693.0,154,148,6
2959,MASSACHUSETTS,Wareham,23956.0,55,45,10
2960,MASSACHUSETTS,Warren,5252.0,9,8,1
2961,MASSACHUSETTS,Watertown,36858.0,82,68,14
2962,MASSACHUSETTS,Wayland,13911.0,24,23,1
2963,MASSACHUSETTS,Webster,16963.0,34,32,2
2964,MASSACHUSETTS,Wellesley,29088.0,57,43,14
2965,MASSACHUSETTS,Wellfleet,2747.0,19,14,5
2966,MASSACHUSETTS,Wenham,5236.0,11,10,1
2967,MASSACHUSETTS,Westborough,19299.0,39,37,2
2968,MASSACHUSETTS,West Brookfield,3749.0,7,6,1
2969,MASSACHUSETTS,Westfield,41474.0,88,84,4
2970,MASSACHUSETTS,Westford,25834.0,50,45,5
2971,MASSACHUSETTS,Westminster,8244.0,19,15,4
2972,MASSACHUSETTS,Weston,12195.0,35,26,9
2973,MASSACHUSETTS,Westport,16286.0,36,31,5
2974,MASSACHUSETTS,Westwood,16767.0,40,33,7
2975,MASSACHUSETTS,Weymouth,59242.0,117,94,23
2976,MASSACHUSETTS,Wilbraham,14864.0,28,27,1
2977,MASSACHUSETTS,Williamsburg,2459.0,2,2,0
2978,MASSACHUSETTS,Wilmington,23567.0,48,44,4
2979,MASSACHUSETTS,Winchendon,10973.0,21,15,6
2980,MASSACHUSETTS,Winchester,22988.0,51,40,11
2981,MASSACHUSETTS,Winthrop,18692.0,33,32,1
2982,MASSACHUSETTS,Woburn,40568.0,81,76,5
2983,MASSACHUSETTS,Worcester,186365.0,497,447,50
2984,MASSACHUSETTS,Worthington,1178.0,1,1,0
2985,MASSACHUSETTS,Wrentham,12334.0,23,22,1
2986,MASSACHUSETTS,Yarmouth,23295.0,75,61,14
2987,MICHIGAN,Adrian,20371.0,31,29,2
2988,MICHIGAN,Adrian Township,6188.0,3,2,1
2989,MICHIGAN,Akron,370.0,1,1,0
2990,MICHIGAN,Albion,8336.0,16,15,1
2991,MICHIGAN,Allegan,5018.0,9,8,1
2992,MICHIGAN,Allen Park,26615.0,40,37,3
2993,MICHIGAN,Alma,8754.0,16,14,2
2994,MICHIGAN,Almont,2830.0,7,7,0
2995,MICHIGAN,Alpena,9828.0,19,17,2
2996,MICHIGAN,Ann Arbor,119805.0,143,115,28
2997,MICHIGAN,Argentine Township,6439.0,5,5,0
2998,MICHIGAN,Armada,1695.0,2,2,0
2999,MICHIGAN,Auburn Hills,25256.0,50,45,5
3000,MICHIGAN,Augusta,897.0,8,6,2
3001,MICHIGAN,Bad Axe,2868.0,7,7,0
3002,MICHIGAN,Bangor,1800.0,7,6,1
3003,MICHIGAN,Baraga,1927.0,2,2,0
3004,MICHIGAN,Baroda-Lake Township,3891.0,6,5,1
3005,MICHIGAN,Barryton ,357.0,1,1,0
3006,MICHIGAN,Barry Township,3560.0,4,4,0
3007,MICHIGAN,Bath Township,13226.0,13,12,1
3008,MICHIGAN,Battle Creek,60134.0,115,100,15
3009,MICHIGAN,Bay City,32200.0,50,47,3
3010,MICHIGAN,Beaverton,1173.0,4,4,0
3011,MICHIGAN,Belding,5738.0,8,8,0
3012,MICHIGAN,Bellaire,1067.0,2,2,0
3013,MICHIGAN,Belleville,3854.0,10,9,1
3014,MICHIGAN,Bellevue,1301.0,2,2,0
3015,MICHIGAN,Benton Harbor,9660.0,14,13,1
3016,MICHIGAN,Benton Township,14230.0,19,17,2
3017,MICHIGAN,Berkley,15307.0,40,30,10
3018,MICHIGAN,Berrien Springs-Oronoko Township,8854.0,9,8,1
3019,MICHIGAN,Beverly Hills,10278.0,27,25,2
3020,MICHIGAN,Big Rapids,10406.0,18,16,2
3021,MICHIGAN,Birch Run,1461.0,7,6,1
3022,MICHIGAN,Birmingham,21436.0,43,32,11
3023,MICHIGAN,Blackman Township,36111.0,42,41,1
3024,MICHIGAN,Blissfield,3240.0,7,6,1
3025,MICHIGAN,Bloomfield Hills,4001.0,28,24,4
3026,MICHIGAN,Bloomfield Township,41809.0,85,67,18
3027,MICHIGAN,Boyne City,3717.0,9,8,1
3028,MICHIGAN,Breckenridge,1259.0,1,1,0
3029,MICHIGAN,Bridgeport Township,9658.0,11,10,1
3030,MICHIGAN,Bridgman,2191.0,5,5,0
3031,MICHIGAN,Brighton,7654.0,19,17,2
3032,MICHIGAN,Bronson,2293.0,5,4,1
3033,MICHIGAN,Brown City,1230.0,2,2,0
3034,MICHIGAN,Brownstown Township,32300.0,38,30,8
3035,MICHIGAN,Buchanan,4200.0,10,9,1
3036,MICHIGAN,Buena Vista Township,8035.0,13,12,1
3037,MICHIGAN,Burton,28319.0,34,32,2
3038,MICHIGAN,Cadillac,10536.0,16,15,1
3039,MICHIGAN,Cambridge Township,5663.0,4,4,0
3040,MICHIGAN,Canton Township,94777.0,119,93,26
3041,MICHIGAN,Capac,1842.0,3,3,0
3042,MICHIGAN,Carleton,2358.0,4,3,1
3043,MICHIGAN,Caro,3967.0,7,7,0
3044,MICHIGAN,Carrollton Township,5560.0,6,6,0
3045,MICHIGAN,Carson City,1104.0,1,1,0
3046,MICHIGAN,Caseville,720.0,2,2,0
3047,MICHIGAN,Caspian-Gaastra,1161.0,1,1,0
3048,MICHIGAN,Cass City,2259.0,4,4,0
3049,MICHIGAN,Cassopolis,1691.0,5,5,0
3050,MICHIGAN,Center Line,8074.0,20,15,5
3051,MICHIGAN,Central Lake,941.0,1,1,0
3052,MICHIGAN,Charlevoix,2477.0,8,7,1
3053,MICHIGAN,Charlotte,9049.0,16,15,1
3054,MICHIGAN,Cheboygan,4682.0,9,9,0
3055,MICHIGAN,Chelsea,5422.0,14,10,4
3056,MICHIGAN,Chesaning,2204.0,2,2,0
3057,MICHIGAN,Chesterfield Township,46997.0,62,48,14
3058,MICHIGAN,Chikaming Township,3073.0,7,6,1
3059,MICHIGAN,Chocolay Township,5888.0,6,5,1
3060,MICHIGAN,Clare,3045.0,7,7,0
3061,MICHIGAN,Clawson,11720.0,15,14,1
3062,MICHIGAN,Clayton Township,7037.0,7,6,1
3063,MICHIGAN,Clay Township,8902.0,23,17,6
3064,MICHIGAN,Clinton,2283.0,4,4,0
3065,MICHIGAN,Clinton Township,100094.0,100,92,8
3066,MICHIGAN,Clio,2465.0,2,2,0
3067,MICHIGAN,Coldwater,11954.0,21,19,2
3068,MICHIGAN,Coleman,1202.0,2,2,0
3069,MICHIGAN,Coloma Township,6307.0,10,7,3
3070,MICHIGAN,Colon,1152.0,3,3,0
3071,MICHIGAN,Columbia Township,7312.0,6,6,0
3072,MICHIGAN,Constantine,2106.0,5,4,1
3073,MICHIGAN,Corunna,3303.0,3,3,0
3074,MICHIGAN,Covert Township,2884.0,9,9,0
3075,MICHIGAN,Croswell,2235.0,5,5,0
3076,MICHIGAN,Crystal Falls,1355.0,1,1,0
3077,MICHIGAN,Davison,4828.0,7,6,1
3078,MICHIGAN,Davison Township,19226.0,22,20,2
3079,MICHIGAN,Dearborn,92930.0,231,190,41
3080,MICHIGAN,Dearborn Heights,54772.0,100,79,21
3081,MICHIGAN,Decatur,1707.0,5,5,0
3082,MICHIGAN,Denton Township,5412.0,4,4,0
3083,MICHIGAN,Detroit,673708.0,3100,2475,625
3084,MICHIGAN,DeWitt,4869.0,7,6,1
3085,MICHIGAN,DeWitt Township,15880.0,17,16,1
3086,MICHIGAN,Dowagiac,5536.0,14,13,1
3087,MICHIGAN,Dryden Township,4731.0,4,4,0
3088,MICHIGAN,Dundee,4769.0,5,5,0
3089,MICHIGAN,Durand,3792.0,5,5,0
3090,MICHIGAN,East Grand Rapids,12129.0,29,27,2
3091,MICHIGAN,East Jordan,2338.0,5,5,0
3092,MICHIGAN,East Lansing,47548.0,58,46,12
3093,MICHIGAN,Eastpointe,31653.0,45,40,5
3094,MICHIGAN,Eaton Rapids,5223.0,10,9,1
3095,MICHIGAN,Eau Claire,588.0,1,1,0
3096,MICHIGAN,Ecorse,9635.0,18,18,0
3097,MICHIGAN,Elk Rapids,1625.0,5,5,0
3098,MICHIGAN,Elkton,735.0,1,1,0
3099,MICHIGAN,Emmett Township,11531.0,17,15,2
3100,MICHIGAN,Erie Township,4302.0,2,2,0
3101,MICHIGAN,Escanaba,12052.0,43,30,13
3102,MICHIGAN,Essexville,3222.0,8,8,0
3103,MICHIGAN,Evart,1883.0,3,3,0
3104,MICHIGAN,Fair Haven Township,1029.0,1,1,0
3105,MICHIGAN,Farmington,10396.0,23,22,1
3106,MICHIGAN,Farmington Hills,80044.0,137,101,36
3107,MICHIGAN,Fennville,1438.0,6,6,0
3108,MICHIGAN,Fenton,11340.0,15,12,3
3109,MICHIGAN,Ferndale,20228.0,51,40,11
3110,MICHIGAN,Flat Rock,9968.0,20,18,2
3111,MICHIGAN,Flint,94290.0,116,99,17
3112,MICHIGAN,Flint Township,30015.0,42,35,7
3113,MICHIGAN,Flushing,7789.0,11,10,1
3114,MICHIGAN,Flushing Township,10096.0,8,8,0
3115,MICHIGAN,Forsyth Township,6160.0,9,7,2
3116,MICHIGAN,Fowlerville,2904.0,7,6,1
3117,MICHIGAN,Frankenmuth,5728.0,9,7,2
3118,MICHIGAN,Frankfort,1290.0,4,4,0
3119,MICHIGAN,Franklin,3228.0,11,11,0
3120,MICHIGAN,Fraser,14316.0,29,28,1
3121,MICHIGAN,Fremont,4102.0,9,8,1
3122,MICHIGAN,Fruitport Township,14690.0,11,10,1
3123,MICHIGAN,Gagetown,358.0,1,1,0
3124,MICHIGAN,Galien,525.0,2,1,1
3125,MICHIGAN,Garden City,26084.0,37,34,3
3126,MICHIGAN,Garfield Township,846.0,1,1,0
3127,MICHIGAN,Gaylord,3672.0,12,11,1
3128,MICHIGAN,Genesee Township,20258.0,19,17,2
3129,MICHIGAN,Gerrish Township,2946.0,7,6,1
3130,MICHIGAN,Gibraltar,4503.0,9,8,1
3131,MICHIGAN,Gladstone,4631.0,11,10,1
3132,MICHIGAN,Gladwin,2884.0,6,6,0
3133,MICHIGAN,Grand Beach/Michiana,462.0,5,5,0
3134,MICHIGAN,Grand Blanc,7789.0,18,16,2
3135,MICHIGAN,Grand Blanc Township,36700.0,46,39,7
3136,MICHIGAN,Grand Haven,11110.0,36,29,7
3137,MICHIGAN,Grand Ledge,7891.0,15,15,0
3138,MICHIGAN,Grand Rapids,201280.0,385,283,102
3139,MICHIGAN,Grandville,15787.0,28,26,2
3140,MICHIGAN,Grant,900.0,2,2,0
3141,MICHIGAN,Grayling,1841.0,6,6,0
3142,MICHIGAN,Green Oak Township,19155.0,18,16,2
3143,MICHIGAN,Greenville,8378.0,17,15,2
3144,MICHIGAN,Grosse Ile Township,10076.0,22,16,6
3145,MICHIGAN,Grosse Pointe,5094.0,23,23,0
3146,MICHIGAN,Grosse Pointe Farms,9012.0,37,32,5
3147,MICHIGAN,Grosse Pointe Park,10918.0,38,33,5
3148,MICHIGAN,Grosse Pointe Shores,2509.0,16,16,0
3149,MICHIGAN,Grosse Pointe Woods,15158.0,36,30,6
3150,MICHIGAN,Hamburg Township,21904.0,19,18,1
3151,MICHIGAN,Hampton Township,9282.0,10,10,0
3152,MICHIGAN,Hamtramck,21346.0,36,29,7
3153,MICHIGAN,Hancock,4426.0,9,9,0
3154,MICHIGAN,Harbor Beach,1557.0,4,4,0
3155,MICHIGAN,Harbor Springs,1204.0,7,6,1
3156,MICHIGAN,Harper Woods,13582.0,29,26,3
3157,MICHIGAN,Hart,2087.0,5,5,0
3158,MICHIGAN,Hartford,2561.0,4,4,0
3159,MICHIGAN,Hastings,7335.0,15,13,2
3160,MICHIGAN,Hazel Park,16189.0,38,33,5
3161,MICHIGAN,Hesperia,935.0,2,2,0
3162,MICHIGAN,Highland Park,10620.0,12,8,4
3163,MICHIGAN,Hillsdale,8081.0,16,14,2
3164,MICHIGAN,Holland,33144.0,68,58,10
3165,MICHIGAN,Holly,6079.0,9,9,0
3166,MICHIGAN,Houghton,7524.0,11,10,1
3167,MICHIGAN,Howell,9667.0,17,15,2
3168,MICHIGAN,Hudson,2185.0,2,2,0
3169,MICHIGAN,Huntington Woods,6199.0,18,17,1
3170,MICHIGAN,Huron Township,16353.0,31,24,7
3171,MICHIGAN,Imlay City,3584.0,8,7,1
3172,MICHIGAN,Inkster,23999.0,39,29,10
3173,MICHIGAN,Ionia,10955.0,16,14,2
3174,MICHIGAN,Iron Mountain,7233.0,15,14,1
3175,MICHIGAN,Iron River,2808.0,3,3,0
3176,MICHIGAN,Ironwood,4760.0,13,13,0
3177,MICHIGAN,Ishpeming,6371.0,12,11,1
3178,MICHIGAN,Ishpeming Township,3496.0,1,1,0
3179,MICHIGAN,Jackson,32271.0,53,43,10
3180,MICHIGAN,Jonesville,2201.0,2,2,0
3181,MICHIGAN,Kalamazoo,76179.0,270,245,25
3182,MICHIGAN,Kalamazoo Township,24503.0,37,32,5
3183,MICHIGAN,Kalkaska,2090.0,8,7,1
3184,MICHIGAN,Keego Harbor,3396.0,5,5,0
3185,MICHIGAN,Kentwood,52028.0,82,69,13
3186,MICHIGAN,Kingsford,4903.0,19,19,0
3187,MICHIGAN,Kingston,404.0,1,1,0
3188,MICHIGAN,Kinross Township,7226.0,2,2,0
3189,MICHIGAN,Laingsburg,1283.0,1,1,0
3190,MICHIGAN,Lake Angelus,309.0,1,1,0
3191,MICHIGAN,Lake Linden,928.0,1,1,0
3192,MICHIGAN,Lake Odessa,2043.0,4,4,0
3193,MICHIGAN,Lake Orion,3207.0,5,4,1
3194,MICHIGAN,Lakeview,993.0,3,3,0
3195,MICHIGAN,L'Anse,1807.0,4,4,0
3196,MICHIGAN,Lansing,117865.0,242,190,52
3197,MICHIGAN,Lansing Township,8158.0,16,15,1
3198,MICHIGAN,Lapeer,8416.0,23,20,3
3199,MICHIGAN,Lathrup Village,4046.0,10,9,1
3200,MICHIGAN,Laurium,1861.0,4,4,0
3201,MICHIGAN,Lawton,1791.0,4,4,0
3202,MICHIGAN,Leslie,1886.0,4,4,0
3203,MICHIGAN,Lexington,1114.0,3,3,0
3204,MICHIGAN,Lincoln Park,35879.0,51,44,7
3205,MICHIGAN,Lincoln Township,14590.0,17,15,2
3206,MICHIGAN,Linden,3950.0,6,6,0
3207,MICHIGAN,Litchfield,1324.0,2,2,0
3208,MICHIGAN,Livonia,92852.0,157,120,37
3209,MICHIGAN,Lowell,4239.0,6,5,1
3210,MICHIGAN,Ludington,8098.0,16,14,2
3211,MICHIGAN,Luna Pier,1389.0,1,1,0
3212,MICHIGAN,Mackinac Island,477.0,6,6,0
3213,MICHIGAN,Mackinaw City,792.0,6,6,0
3214,MICHIGAN,Madison Heights,29626.0,68,51,17
3215,MICHIGAN,Madison Township,7959.0,5,5,0
3216,MICHIGAN,Mancelona,1374.0,1,1,0
3217,MICHIGAN,Manistee,6158.0,12,12,0
3218,MICHIGAN,Manistique,2933.0,8,8,0
3219,MICHIGAN,Manton,1625.0,1,1,0
3220,MICHIGAN,Marine City,4015.0,6,5,1
3221,MICHIGAN,Marlette,1740.0,4,4,0
3222,MICHIGAN,Marquette,20208.0,37,33,4
3223,MICHIGAN,Marshall,6910.0,15,15,0
3224,MICHIGAN,Marysville,9621.0,16,14,2
3225,MICHIGAN,Mason,8402.0,13,12,1
3226,MICHIGAN,Mattawan,1972.0,6,6,0
3227,MICHIGAN,Mayville,878.0,3,3,0
3228,MICHIGAN,Melvindale,10134.0,23,23,0
3229,MICHIGAN,Memphis,1167.0,3,3,0
3230,MICHIGAN,Mendon,845.0,1,1,0
3231,MICHIGAN,Menominee,7909.0,17,16,1
3232,MICHIGAN,Meridian Township,43146.0,40,37,3
3233,MICHIGAN,Metamora Township,4323.0,5,5,0
3234,MICHIGAN,Metro Police Authority of Genesee County,19899.0,27,24,3
3235,MICHIGAN,Midland,41758.0,52,50,2
3236,MICHIGAN,Milan,6028.0,17,12,5
3237,MICHIGAN,Milford,16969.0,21,19,2
3238,MICHIGAN,Millington,1002.0,2,2,0
3239,MICHIGAN,Monroe,19209.0,44,40,4
3240,MICHIGAN,Montague,2366.0,5,5,0
3241,MICHIGAN,Montrose Township,7420.0,8,8,0
3242,MICHIGAN,Morenci,2120.0,9,8,1
3243,MICHIGAN,Morrice,904.0,1,1,0
3244,MICHIGAN,Mount Morris,2803.0,5,5,0
3245,MICHIGAN,Mount Morris Township,20084.0,31,28,3
3246,MICHIGAN,Mount Pleasant,24109.0,33,27,6
3247,MICHIGAN,Munising,2171.0,5,5,0
3248,MICHIGAN,Muskegon,36296.0,78,67,11
3249,MICHIGAN,Muskegon Heights,10673.0,27,24,3
3250,MICHIGAN,Muskegon Township,18043.0,16,16,0
3251,MICHIGAN,Napoleon Township,6696.0,5,5,0
3252,MICHIGAN,Nashville,1704.0,3,3,0
3253,MICHIGAN,Negaunee,4494.0,8,8,0
3254,MICHIGAN,Newaygo,2110.0,7,7,0
3255,MICHIGAN,New Baltimore,12301.0,18,16,2
3256,MICHIGAN,New Buffalo,1863.0,7,7,0
3257,MICHIGAN,New Era,439.0,1,1,0
3258,MICHIGAN,Niles,11045.0,28,18,10
3259,MICHIGAN,Northfield Township,8679.0,13,11,2
3260,MICHIGAN,North Muskegon,3792.0,8,8,0
3261,MICHIGAN,Northville,5922.0,13,12,1
3262,MICHIGAN,Northville Township,29443.0,49,35,14
3263,MICHIGAN,Norton Shores,24689.0,41,38,3
3264,MICHIGAN,Norway,2702.0,6,6,0
3265,MICHIGAN,Novi,61440.0,90,68,22
3266,MICHIGAN,Oak Park,29280.0,63,50,13
3267,MICHIGAN,Olivet,1887.0,1,1,0
3268,MICHIGAN,Ontwa Township-Edwardsburg,6574.0,11,10,1
3269,MICHIGAN,Orchard Lake,2480.0,12,11,1
3270,MICHIGAN,Oscoda Township,6743.0,12,11,1
3271,MICHIGAN,Otsego,3990.0,8,7,1
3272,MICHIGAN,Ovid,1609.0,2,2,0
3273,MICHIGAN,Owosso,14258.0,20,18,2
3274,MICHIGAN,Oxford,3552.0,23,9,14
3275,MICHIGAN,Paw Paw,3328.0,9,8,1
3276,MICHIGAN,Pentwater,858.0,2,2,0
3277,MICHIGAN,Perry,2066.0,4,4,0
3278,MICHIGAN,Petoskey,5734.0,20,19,1
3279,MICHIGAN,Pigeon,1099.0,2,2,0
3280,MICHIGAN,Pinckney,2425.0,6,6,0
3281,MICHIGAN,Pittsfield Township,39327.0,37,35,2
3282,MICHIGAN,Plainwell,3771.0,9,8,1
3283,MICHIGAN,Pleasant Ridge,2399.0,5,5,0
3284,MICHIGAN,Plymouth,9141.0,15,14,1
3285,MICHIGAN,Plymouth Township,26895.0,44,29,15
3286,MICHIGAN,Portage,50141.0,72,60,12
3287,MICHIGAN,Port Austin,610.0,2,2,0
3288,MICHIGAN,Port Huron,28487.0,62,54,8
3289,MICHIGAN,Portland,4024.0,6,6,0
3290,MICHIGAN,Potterville,2778.0,2,2,0
3291,MICHIGAN,Prairieville Township,3548.0,2,2,0
3292,MICHIGAN,Quincy,1614.0,4,4,0
3293,MICHIGAN,Raisin Township,7817.0,4,4,0
3294,MICHIGAN,Reading,1039.0,2,2,0
3295,MICHIGAN,Redford Township,46112.0,62,54,8
3296,MICHIGAN,Reed City,2372.0,4,4,0
3297,MICHIGAN,Reese,1358.0,2,2,0
3298,MICHIGAN,"Richfield Township, Genesee County",8300.0,11,9,2
3299,MICHIGAN,"Richfield Township, Roscommon County",3642.0,5,5,0
3300,MICHIGAN,Richland,858.0,3,3,0
3301,MICHIGAN,"Richland Township, Saginaw County",3891.0,4,4,0
3302,MICHIGAN,Richmond,5801.0,14,11,3
3303,MICHIGAN,River Rouge,7319.0,27,19,8
3304,MICHIGAN,Riverview,11920.0,21,20,1
3305,MICHIGAN,Rochester,13251.0,30,22,8
3306,MICHIGAN,Rockford,6468.0,11,10,1
3307,MICHIGAN,Rockwood,3133.0,14,7,7
3308,MICHIGAN,Rogers City,2651.0,6,6,0
3309,MICHIGAN,Romeo,3569.0,9,6,3
3310,MICHIGAN,Romulus,23488.0,60,43,17
3311,MICHIGAN,Roosevelt Park,3781.0,5,5,0
3312,MICHIGAN,Roseville,46456.0,72,69,3
3313,MICHIGAN,Royal Oak,59137.0,107,75,32
3314,MICHIGAN,Saginaw,47480.0,60,51,9
3315,MICHIGAN,Saginaw Township,38836.0,48,43,5
3316,MICHIGAN,Saline,9402.0,19,15,4
3317,MICHIGAN,Sandusky,2477.0,6,5,1
3318,MICHIGAN,Saugatuck-Douglas,2337.0,5,4,1
3319,MICHIGAN,Sault Ste. Marie,13282.0,24,22,2
3320,MICHIGAN,Schoolcraft,1550.0,3,3,0
3321,MICHIGAN,Scottville,1209.0,3,3,0
3322,MICHIGAN,Sebewaing,1597.0,2,2,0
3323,MICHIGAN,Shelby,2042.0,2,2,0
3324,MICHIGAN,Shelby Township,82164.0,93,73,20
3325,MICHIGAN,Shepherd,1488.0,2,2,0
3326,MICHIGAN,Somerset Township,4520.0,3,3,0
3327,MICHIGAN,Southfield,72216.0,154,122,32
3328,MICHIGAN,Southgate,29052.0,43,37,6
3329,MICHIGAN,South Haven,4320.0,24,19,5
3330,MICHIGAN,South Lyon,11899.0,17,16,1
3331,MICHIGAN,South Rockwood,1646.0,2,2,0
3332,MICHIGAN,Sparta,4437.0,5,5,0
3333,MICHIGAN,Spring Arbor Township,7684.0,2,2,0
3334,MICHIGAN,Springport Township,2134.0,2,2,0
3335,MICHIGAN,Stanton,1421.0,1,1,0
3336,MICHIGAN,St. Charles,1871.0,2,2,0
3337,MICHIGAN,St. Clair,5500.0,7,7,0
3338,MICHIGAN,St. Clair Shores,58254.0,87,82,5
3339,MICHIGAN,Sterling Heights,131911.0,174,149,25
3340,MICHIGAN,St. Ignace,2315.0,5,5,0
3341,MICHIGAN,St. Johns,7908.0,13,11,2
3342,MICHIGAN,St. Joseph,8283.0,24,22,2
3343,MICHIGAN,St. Joseph Township,9602.0,13,12,1
3344,MICHIGAN,St. Louis,7051.0,10,7,3
3345,MICHIGAN,Stockbridge,1243.0,2,2,0
3346,MICHIGAN,Sturgis,10771.0,24,19,5
3347,MICHIGAN,Sumpter Township,9337.0,20,16,4
3348,MICHIGAN,Sylvan Lake,1848.0,5,5,0
3349,MICHIGAN,Tawas City,1777.0,3,3,0
3350,MICHIGAN,Taylor,60341.0,88,71,17
3351,MICHIGAN,Tecumseh,8369.0,14,13,1
3352,MICHIGAN,Thetford Township,6567.0,1,1,0
3353,MICHIGAN,Thomas Township,11366.0,9,8,1
3354,MICHIGAN,Three Oaks,1533.0,3,3,0
3355,MICHIGAN,Three Rivers,7579.0,18,16,2
3356,MICHIGAN,Tittabawassee Township,10031.0,8,7,1
3357,MICHIGAN,Traverse City,15840.0,32,30,2
3358,MICHIGAN,Trenton,17954.0,33,32,1
3359,MICHIGAN,Troy,83851.0,152,107,45
3360,MICHIGAN,Tuscarora Township,2918.0,9,8,1
3361,MICHIGAN,Ubly,771.0,1,1,0
3362,MICHIGAN,Unadilla Township,3483.0,3,3,0
3363,MICHIGAN,Union City,1561.0,5,5,0
3364,MICHIGAN,Utica,5094.0,21,15,6
3365,MICHIGAN,Van Buren Township,28390.0,54,40,14
3366,MICHIGAN,Vassar,2521.0,5,5,0
3367,MICHIGAN,Vernon,762.0,1,1,0
3368,MICHIGAN,Vicksburg,3657.0,6,6,0
3369,MICHIGAN,Walker,25443.0,42,38,4
3370,MICHIGAN,Walled Lake,7082.0,7,7,0
3371,MICHIGAN,Warren,132758.0,248,209,39
3372,MICHIGAN,Waterford Township,72213.0,81,62,19
3373,MICHIGAN,Watersmeet Township,1346.0,1,1,0
3374,MICHIGAN,Watervliet,1627.0,4,4,0
3375,MICHIGAN,Wayland,4253.0,7,6,1
3376,MICHIGAN,Wayne,16616.0,24,23,1
3377,MICHIGAN,West Bloomfield Township,65720.0,109,78,31
3378,MICHIGAN,West Branch,2037.0,6,6,0
3379,MICHIGAN,Westland,80837.0,99,74,25
3380,MICHIGAN,White Cloud,1381.0,3,3,0
3381,MICHIGAN,Whitehall,2879.0,8,8,0
3382,MICHIGAN,White Lake Township,31747.0,35,27,8
3383,MICHIGAN,White Pigeon,1520.0,4,4,0
3384,MICHIGAN,Williamston,3935.0,7,6,1
3385,MICHIGAN,Wixom,14145.0,23,20,3
3386,MICHIGAN,Wolverine Lake,4788.0,7,7,0
3387,MICHIGAN,Woodhaven,12388.0,31,29,2
3388,MICHIGAN,Wyandotte,24600.0,48,36,12
3389,MICHIGAN,Wyoming,77094.0,112,92,20
3390,MICHIGAN,Yale,1853.0,5,5,0
3391,MICHIGAN,Ypsilanti,19986.0,34,30,4
3392,MICHIGAN,Zeeland,5524.0,11,10,1
3393,MICHIGAN,Zilwaukee,1504.0,1,1,0
3394,MINNESOTA,Ada,1542.0,4,3,1
3395,MINNESOTA,Aitkin,1954.0,8,7,1
3396,MINNESOTA,Akeley,450.0,1,1,0
3397,MINNESOTA,Albany,2813.0,5,4,1
3398,MINNESOTA,Albert Lea,17686.0,30,27,3
3399,MINNESOTA,Alexandria,14032.0,27,24,3
3400,MINNESOTA,Annandale,3579.0,6,5,1
3401,MINNESOTA,Anoka,17553.0,40,29,11
3402,MINNESOTA,Appleton,1301.0,3,3,0
3403,MINNESOTA,Apple Valley,55455.0,60,52,8
3404,MINNESOTA,Arlington,2102.0,3,2,1
3405,MINNESOTA,Atwater,1111.0,1,1,0
3406,MINNESOTA,Audubon,517.0,1,1,0
3407,MINNESOTA,Austin,25382.0,35,32,3
3408,MINNESOTA,Avon,1680.0,4,3,1
3409,MINNESOTA,Babbitt,1471.0,5,5,0
3410,MINNESOTA,Bagley,1445.0,3,3,0
3411,MINNESOTA,Barnesville,2628.0,5,5,0
3412,MINNESOTA,Battle Lake,935.0,3,3,0
3413,MINNESOTA,Baxter,8571.0,16,15,1
3414,MINNESOTA,Bayport,3822.0,6,6,0
3415,MINNESOTA,Becker,5080.0,8,7,1
3416,MINNESOTA,Belgrade/Brooten,1543.0,3,3,0
3417,MINNESOTA,Belle Plaine,7166.0,13,11,2
3418,MINNESOTA,Bemidji,15574.0,37,34,3
3419,MINNESOTA,Benson,2977.0,8,7,1
3420,MINNESOTA,Big Lake,11721.0,16,14,2
3421,MINNESOTA,Blaine,67705.0,81,70,11
3422,MINNESOTA,Blooming Prairie,1921.0,3,3,0
3423,MINNESOTA,Bloomington,84740.0,149,116,33
3424,MINNESOTA,Blue Earth,3078.0,5,5,0
3425,MINNESOTA,Bovey,782.0,2,2,0
3426,MINNESOTA,Braham,1856.0,6,6,0
3427,MINNESOTA,Brainerd,13436.0,30,24,6
3428,MINNESOTA,Breckenridge,3111.0,8,8,0
3429,MINNESOTA,Breezy Point,2447.0,7,6,1
3430,MINNESOTA,Breitung Township,613.0,1,1,0
3431,MINNESOTA,Brooklyn Center,30258.0,45,35,10
3432,MINNESOTA,Brooklyn Park,79946.0,147,98,49
3433,MINNESOTA,Brownton,706.0,1,1,0
3434,MINNESOTA,Buffalo,16994.0,20,17,3
3435,MINNESOTA,Buffalo Lake,672.0,2,2,0
3436,MINNESOTA,Burnsville,62351.0,87,76,11
3437,MINNESOTA,Caledonia,2743.0,6,5,1
3438,MINNESOTA,Callaway,226.0,1,1,0
3439,MINNESOTA,Cambridge,9540.0,16,14,2
3440,MINNESOTA,Canby,1631.0,3,3,0
3441,MINNESOTA,Cannon Falls,4016.0,8,7,1
3442,MINNESOTA,Centennial Lakes,11721.0,18,16,2
3443,MINNESOTA,Champlin,25249.0,31,26,5
3444,MINNESOTA,Chaska,27632.0,31,26,5
3445,MINNESOTA,Chatfield,2831.0,5,5,0
3446,MINNESOTA,Chisholm,4786.0,12,11,1
3447,MINNESOTA,Clara City,1265.0,2,2,0
3448,MINNESOTA,Clearbrook,537.0,1,1,0
3449,MINNESOTA,Cleveland,733.0,1,1,0
3450,MINNESOTA,Cloquet,12002.0,24,22,2
3451,MINNESOTA,Cold Spring/Richmond,5869.0,11,10,1
3452,MINNESOTA,Coleraine,1972.0,2,2,0
3453,MINNESOTA,Columbia Heights,21238.0,33,26,7
3454,MINNESOTA,Coon Rapids,63076.0,79,69,10
3455,MINNESOTA,Corcoran,6742.0,12,11,1
3456,MINNESOTA,Cottage Grove,38534.0,50,42,8
3457,MINNESOTA,Crookston,7605.0,16,14,2
3458,MINNESOTA,Crosby,2308.0,9,8,1
3459,MINNESOTA,Crosslake,2399.0,6,6,0
3460,MINNESOTA,Crystal,22628.0,40,34,6
3461,MINNESOTA,Danube,446.0,1,1,0
3462,MINNESOTA,Dawson/Boyd,1514.0,2,2,0
3463,MINNESOTA,Dayton,7754.0,11,9,2
3464,MINNESOTA,Deephaven,3926.0,9,8,1
3465,MINNESOTA,Deer River,929.0,4,4,0
3466,MINNESOTA,Deerwood,752.0,3,3,0
3467,MINNESOTA,Detroit Lakes,9310.0,19,17,2
3468,MINNESOTA,Dilworth,4497.0,8,7,1
3469,MINNESOTA,Duluth,85731.0,177,151,26
3470,MINNESOTA,Dundas,1682.0,3,3,0
3471,MINNESOTA,Eagan,66155.0,87,73,14
3472,MINNESOTA,Eagle Lake,3204.0,3,3,0
3473,MINNESOTA,East Grand Forks,8379.0,23,22,1
3474,MINNESOTA,East Range,3521.0,8,8,0
3475,MINNESOTA,Eden Prairie,65308.0,88,67,21
3476,MINNESOTA,Eden Valley,1037.0,1,1,0
3477,MINNESOTA,Edina,52943.0,84,57,27
3478,MINNESOTA,Elko New Market,4800.0,6,6,0
3479,MINNESOTA,Elk River,25873.0,44,35,9
3480,MINNESOTA,Ely,3313.0,6,5,1
3481,MINNESOTA,Emily,844.0,2,2,0
3482,MINNESOTA,Eveleth,3519.0,11,10,1
3483,MINNESOTA,Fairfax,1108.0,7,7,0
3484,MINNESOTA,Fairmont,9852.0,20,18,2
3485,MINNESOTA,Faribault,23960.0,43,34,9
3486,MINNESOTA,Farmington,23235.0,28,25,3
3487,MINNESOTA,Fergus Falls,13791.0,29,24,5
3488,MINNESOTA,Foley,2678.0,4,4,0
3489,MINNESOTA,Forest Lake,21592.0,28,25,3
3490,MINNESOTA,Frazee,1384.0,3,3,0
3491,MINNESOTA,Fridley,27919.0,54,46,8
3492,MINNESOTA,Fulda,1196.0,2,2,0
3493,MINNESOTA,Gaylord,2237.0,4,4,0
3494,MINNESOTA,Gibbon,735.0,1,1,0
3495,MINNESOTA,Gilbert,1758.0,8,7,1
3496,MINNESOTA,Glencoe,5484.0,9,8,1
3497,MINNESOTA,Glenwood,2610.0,63,25,38
3498,MINNESOTA,Glyndon,1384.0,4,4,0
3499,MINNESOTA,Golden Valley,21740.0,36,27,9
3500,MINNESOTA,Goodhue,1163.0,3,3,0
3501,MINNESOTA,Goodview,4138.0,6,5,1
3502,MINNESOTA,Grand Rapids,11255.0,23,20,3
3503,MINNESOTA,Granite Falls,2648.0,7,6,1
3504,MINNESOTA,Hallock,896.0,1,1,0
3505,MINNESOTA,Hastings,22955.0,34,30,4
3506,MINNESOTA,Hawley,2225.0,5,5,0
3507,MINNESOTA,Hector,1031.0,1,1,0
3508,MINNESOTA,Henderson,922.0,2,2,0
3509,MINNESOTA,Henning,806.0,2,2,0
3510,MINNESOTA,Hermantown,9512.0,19,16,3
3511,MINNESOTA,Heron Lake,638.0,1,1,0
3512,MINNESOTA,Hibbing,15655.0,31,28,3
3513,MINNESOTA,Hill City,575.0,1,1,0
3514,MINNESOTA,Hokah,545.0,1,1,0
3515,MINNESOTA,Hopkins,18272.0,37,30,7
3516,MINNESOTA,Houston,970.0,2,2,0
3517,MINNESOTA,Howard Lake,2182.0,3,3,0
3518,MINNESOTA,Hutchinson,13961.0,32,23,9
3519,MINNESOTA,International Falls,5648.0,12,12,0
3520,MINNESOTA,Inver Grove Heights,35957.0,44,39,5
3521,MINNESOTA,Isanti,6576.0,11,10,1
3522,MINNESOTA,Isle,793.0,4,4,0
3523,MINNESOTA,Janesville,2246.0,4,4,0
3524,MINNESOTA,Jordan,6523.0,9,7,2
3525,MINNESOTA,Kasson,6585.0,9,9,0
3526,MINNESOTA,Keewatin,1006.0,3,3,0
3527,MINNESOTA,La Crescent,5027.0,9,8,1
3528,MINNESOTA,Lake City,5119.0,11,10,1
3529,MINNESOTA,Lake Crystal,2508.0,3,3,0
3530,MINNESOTA,Lakefield,1591.0,3,3,0
3531,MINNESOTA,Lake Park,788.0,2,2,0
3532,MINNESOTA,Lakes Area,10026.0,15,13,2
3533,MINNESOTA,Lake Shore,1076.0,2,2,0
3534,MINNESOTA,Lakeville,71092.0,71,61,10
3535,MINNESOTA,Le Center,2480.0,3,3,0
3536,MINNESOTA,Lester Prairie,1720.0,3,3,0
3537,MINNESOTA,Le Sueur,4029.0,8,7,1
3538,MINNESOTA,Lewiston,1536.0,2,2,0
3539,MINNESOTA,Lino Lakes,22657.0,30,26,4
3540,MINNESOTA,Litchfield,6656.0,11,10,1
3541,MINNESOTA,Little Falls,8597.0,16,14,2
3542,MINNESOTA,Long Prairie,3282.0,6,6,0
3543,MINNESOTA,Lonsdale,4366.0,8,7,1
3544,MINNESOTA,Madelia,2217.0,3,3,0
3545,MINNESOTA,Madison Lake,1215.0,2,2,0
3546,MINNESOTA,Mankato,43802.0,61,54,7
3547,MINNESOTA,Maple Grove,74097.0,82,69,13
3548,MINNESOTA,Mapleton,2178.0,3,3,0
3549,MINNESOTA,Maplewood,41057.0,55,50,5
3550,MINNESOTA,Marshall,13391.0,24,21,3
3551,MINNESOTA,Medina,6969.0,12,11,1
3552,MINNESOTA,Melrose,3680.0,6,5,1
3553,MINNESOTA,Menahga,1308.0,3,3,0
3554,MINNESOTA,Mendota Heights,11469.0,20,19,1
3555,MINNESOTA,Milaca,2894.0,8,7,1
3556,MINNESOTA,Minneapolis,438463.0,774,648,126
3557,MINNESOTA,Minneota,1334.0,1,1,0
3558,MINNESOTA,Minnesota Lake,630.0,1,1,0
3559,MINNESOTA,Minnetonka,55960.0,65,55,10
3560,MINNESOTA,Minnetrista,11095.0,17,13,4
3561,MINNESOTA,Montevideo,4995.0,12,11,1
3562,MINNESOTA,Montgomery,3062.0,7,6,1
3563,MINNESOTA,Moorhead,44488.0,73,58,15
3564,MINNESOTA,Moose Lake,2788.0,5,5,0
3565,MINNESOTA,Morris,5319.0,10,8,2
3566,MINNESOTA,Motley,651.0,1,1,0
3567,MINNESOTA,Mounds View,13625.0,23,21,2
3568,MINNESOTA,Mountain Lake,2037.0,4,4,0
3569,MINNESOTA,Nashwauk,947.0,4,4,0
3570,MINNESOTA,New Brighton,23012.0,34,27,7
3571,MINNESOTA,New Hope,20671.0,42,33,9
3572,MINNESOTA,New Prague,8293.0,11,9,2
3573,MINNESOTA,New Richland,1167.0,2,2,0
3574,MINNESOTA,New Ulm,13106.0,22,22,0
3575,MINNESOTA,New York Mills,1222.0,3,3,0
3576,MINNESOTA,Nisswa,2130.0,6,6,0
3577,MINNESOTA,North Branch,10908.0,14,12,2
3578,MINNESOTA,Northfield,20828.0,29,24,5
3579,MINNESOTA,North Mankato,14117.0,16,15,1
3580,MINNESOTA,North St. Paul,12557.0,18,16,2
3581,MINNESOTA,Oakdale,27808.0,39,31,8
3582,MINNESOTA,Oak Park Heights,5031.0,11,10,1
3583,MINNESOTA,Olivia,2291.0,5,5,0
3584,MINNESOTA,Onamia,856.0,3,3,0
3585,MINNESOTA,Orono,20241.0,31,27,4
3586,MINNESOTA,Ortonville,1732.0,4,4,0
3587,MINNESOTA,Osakis,1742.0,3,3,0
3588,MINNESOTA,Osseo,2732.0,8,7,1
3589,MINNESOTA,Owatonna,25683.0,40,36,4
3590,MINNESOTA,Parkers Prairie,991.0,2,2,0
3591,MINNESOTA,Park Rapids,4387.0,12,11,1
3592,MINNESOTA,Paynesville,2542.0,4,4,0
3593,MINNESOTA,Pelican Rapids,2652.0,5,5,0
3594,MINNESOTA,Pequot Lakes,2320.0,7,6,1
3595,MINNESOTA,Perham,3708.0,8,7,1
3596,MINNESOTA,Pierz,1361.0,2,2,0
3597,MINNESOTA,Pillager,488.0,2,2,0
3598,MINNESOTA,Pine River,932.0,4,4,0
3599,MINNESOTA,Plainview,3287.0,9,8,1
3600,MINNESOTA,Plymouth,80588.0,94,78,16
3601,MINNESOTA,Preston,1275.0,3,3,0
3602,MINNESOTA,Princeton,4738.0,14,12,2
3603,MINNESOTA,Prior Lake,27779.0,34,30,4
3604,MINNESOTA,Proctor,3001.0,7,6,1
3605,MINNESOTA,Ramsey,29053.0,32,29,3
3606,MINNESOTA,Red Wing,16411.0,30,26,4
3607,MINNESOTA,Redwood Falls,4914.0,14,12,2
3608,MINNESOTA,Renville,1151.0,3,3,0
3609,MINNESOTA,Rice,1413.0,2,2,0
3610,MINNESOTA,Richfield,36336.0,54,44,10
3611,MINNESOTA,Robbinsdale,14213.0,29,25,4
3612,MINNESOTA,Rochester,121225.0,211,144,67
3613,MINNESOTA,Rogers,13889.0,25,21,4
3614,MINNESOTA,Roseau,2662.0,6,5,1
3615,MINNESOTA,Rosemount,26218.0,32,29,3
3616,MINNESOTA,Roseville,36561.0,61,53,8
3617,MINNESOTA,Rushford,1692.0,3,3,0
3618,MINNESOTA,Sartell,19398.0,24,21,3
3619,MINNESOTA,Sauk Centre,4556.0,9,8,1
3620,MINNESOTA,Sauk Rapids,14489.0,18,17,1
3621,MINNESOTA,Savage,33510.0,43,33,10
3622,MINNESOTA,Sebeka,664.0,2,2,0
3623,MINNESOTA,Shakopee,43641.0,60,48,12
3624,MINNESOTA,Sherburn,1072.0,4,4,0
3625,MINNESOTA,Silver Bay,1739.0,4,4,0
3626,MINNESOTA,Slayton,1941.0,6,5,1
3627,MINNESOTA,Sleepy Eye,3304.0,7,7,0
3628,MINNESOTA,South Lake Minnetonka,12833.0,18,15,3
3629,MINNESOTA,South St. Paul,19895.0,36,32,4
3630,MINNESOTA,Springfield,1975.0,4,4,0
3631,MINNESOTA,Spring Grove,1255.0,3,3,0
3632,MINNESOTA,Spring Lake Park,6960.0,13,10,3
3633,MINNESOTA,St. Anthony,11490.0,23,20,3
3634,MINNESOTA,Staples,3074.0,8,7,1
3635,MINNESOTA,Starbuck,1264.0,4,4,0
3636,MINNESOTA,St. Charles,3771.0,7,7,0
3637,MINNESOTA,St. Cloud,68756.0,140,113,27
3638,MINNESOTA,St. Francis,8154.0,15,12,3
3639,MINNESOTA,Stillwater,19799.0,28,23,5
3640,MINNESOTA,St. James,4336.0,8,7,1
3641,MINNESOTA,St. Joseph,7864.0,13,11,2
3642,MINNESOTA,St. Louis Park,49196.0,73,58,15
3643,MINNESOTA,St. Paul,309957.0,760,627,133
3644,MINNESOTA,St. Paul Park,5359.0,8,8,0
3645,MINNESOTA,St. Peter,12121.0,20,14,6
3646,MINNESOTA,Thief River Falls,8693.0,18,16,2
3647,MINNESOTA,Tracy,2045.0,3,3,0
3648,MINNESOTA,Trimont,686.0,1,1,0
3649,MINNESOTA,Truman,1020.0,2,2,0
3650,MINNESOTA,Twin Valley,743.0,2,2,0
3651,MINNESOTA,Two Harbors,3486.0,9,8,1
3652,MINNESOTA,Tyler,1050.0,1,1,0
3653,MINNESOTA,Verndale,574.0,2,2,0
3654,MINNESOTA,Virginia,8259.0,24,24,0
3655,MINNESOTA,Wabasha,2462.0,9,8,1
3656,MINNESOTA,Wadena,4126.0,10,9,1
3657,MINNESOTA,Waite Park,7839.0,23,20,3
3658,MINNESOTA,Walker,926.0,3,3,0
3659,MINNESOTA,Walnut Grove,791.0,1,1,0
3660,MINNESOTA,Warroad,1792.0,5,5,0
3661,MINNESOTA,Waseca,8779.0,19,17,2
3662,MINNESOTA,Waterville,1870.0,4,4,0
3663,MINNESOTA,Wayzata,6519.0,17,15,2
3664,MINNESOTA,Wells,2141.0,5,5,0
3665,MINNESOTA,Westbrook,709.0,1,1,0
3666,MINNESOTA,West Concord,761.0,1,1,0
3667,MINNESOTA,West Hennepin,5955.0,11,9,2
3668,MINNESOTA,West St. Paul,19840.0,38,34,4
3669,MINNESOTA,Wheaton,1255.0,3,3,0
3670,MINNESOTA,White Bear Lake,25747.0,35,31,4
3671,MINNESOTA,Willmar,19922.0,40,35,5
3672,MINNESOTA,Windom,4380.0,11,10,1
3673,MINNESOTA,Winnebago,1324.0,3,3,0
3674,MINNESOTA,Winona,26446.0,41,38,3
3675,MINNESOTA,Winsted,2220.0,4,4,0
3676,MINNESOTA,Winthrop,1315.0,3,3,0
3677,MINNESOTA,Woodbury,75577.0,87,68,19
3678,MINNESOTA,Worthington,12983.0,34,23,11
3679,MINNESOTA,Wyoming,8112.0,12,10,2
3680,MINNESOTA,Zumbrota,3556.0,6,6,0
3681,MISSISSIPPI,Aberdeen,5236.0,19,13,6
3682,MISSISSIPPI,Ackerman,1407.0,5,5,0
3683,MISSISSIPPI,Batesville,7085.0,50,37,13
3684,MISSISSIPPI,Bay Springs,1638.0,7,7,0
3685,MISSISSIPPI,Bay St. Louis,15188.0,28,26,2
3686,MISSISSIPPI,Biloxi,46317.0,181,128,53
3687,MISSISSIPPI,Brandon,24639.0,42,30,12
3688,MISSISSIPPI,Brookhaven,11798.0,41,29,12
3689,MISSISSIPPI,Bruce,1784.0,6,6,0
3690,MISSISSIPPI,Byhalia,1204.0,13,8,5
3691,MISSISSIPPI,Byram,11240.0,38,27,11
3692,MISSISSIPPI,Calhoun City,1637.0,5,5,0
3693,MISSISSIPPI,Canton,11801.0,35,23,12
3694,MISSISSIPPI,Clarksdale,14164.0,30,24,6
3695,MISSISSIPPI,Cleveland,10710.0,50,44,6
3696,MISSISSIPPI,Clinton,23737.0,76,59,17
3697,MISSISSIPPI,Columbus,23124.0,61,51,10
3698,MISSISSIPPI,Corinth,14421.0,43,38,5
3699,MISSISSIPPI,Derma,955.0,1,1,0
3700,MISSISSIPPI,D'Iberville,14234.0,40,37,3
3701,MISSISSIPPI,Ellisville,4563.0,11,9,2
3702,MISSISSIPPI,Florence,4573.0,21,15,6
3703,MISSISSIPPI,Flowood,9743.0,63,50,13
3704,MISSISSIPPI,Gautier,18362.0,39,28,11
3705,MISSISSIPPI,Gloster,843.0,8,2,6
3706,MISSISSIPPI,Greenwood,13215.0,50,33,17
3707,MISSISSIPPI,Gulfport,71803.0,201,148,53
3708,MISSISSIPPI,Hattiesburg,45809.0,164,104,60
3709,MISSISSIPPI,Hazlehurst,3656.0,20,12,8
3710,MISSISSIPPI,Holly Springs,7674.0,23,17,6
3711,MISSISSIPPI,Horn Lake,27401.0,64,47,17
3712,MISSISSIPPI,Houston,3351.0,10,10,0
3713,MISSISSIPPI,Iuka,2917.0,12,9,3
3714,MISSISSIPPI,Jackson,156320.0,416,278,138
3715,MISSISSIPPI,Kosciusko,6545.0,19,19,0
3716,MISSISSIPPI,Laurel,18165.0,66,47,19
3717,MISSISSIPPI,Leland,3587.0,20,13,7
3718,MISSISSIPPI,Long Beach,16260.0,43,30,13
3719,MISSISSIPPI,Louisville,5861.0,27,16,11
3720,MISSISSIPPI,Lucedale,3140.0,20,14,6
3721,MISSISSIPPI,Lumberton,2262.0,8,7,1
3722,MISSISSIPPI,Madison,25860.0,86,63,23
3723,MISSISSIPPI,Magee,4062.0,25,16,9
3724,MISSISSIPPI,Mathiston,665.0,4,3,1
3725,MISSISSIPPI,McComb,12819.0,43,26,17
3726,MISSISSIPPI,Mendenhall,2382.0,8,5,3
3727,MISSISSIPPI,Morton,3505.0,12,6,6
3728,MISSISSIPPI,Moss Point,13182.0,39,27,12
3729,MISSISSIPPI,Oakland,489.0,3,1,2
3730,MISSISSIPPI,Ocean Springs,17833.0,49,37,12
3731,MISSISSIPPI,Okolona,2563.0,6,6,0
3732,MISSISSIPPI,Olive Branch,40308.0,90,81,9
3733,MISSISSIPPI,Oxford,29367.0,94,75,19
3734,MISSISSIPPI,Pascagoula,21468.0,74,52,22
3735,MISSISSIPPI,Pass Christian,6724.0,29,21,8
3736,MISSISSIPPI,Pelahatchie,1393.0,10,7,3
3737,MISSISSIPPI,Philadelphia,6959.0,34,26,8
3738,MISSISSIPPI,Picayune,10814.0,35,30,5
3739,MISSISSIPPI,Pontotoc,6297.0,23,20,3
3740,MISSISSIPPI,Poplarville,2771.0,9,9,0
3741,MISSISSIPPI,Raymond,2101.0,5,5,0
3742,MISSISSIPPI,Richland,7305.0,28,14,14
3743,MISSISSIPPI,Ridgeland,23901.0,84,59,25
3744,MISSISSIPPI,Ripley,5168.0,16,15,1
3745,MISSISSIPPI,Ruleville,2466.0,15,15,0
3746,MISSISSIPPI,Saltillo,5105.0,14,14,0
3747,MISSISSIPPI,Seminary,281.0,1,1,0
3748,MISSISSIPPI,Senatobia,7562.0,38,30,8
3749,MISSISSIPPI,Smithville,722.0,1,1,0
3750,MISSISSIPPI,Southaven,57455.0,158,125,33
3751,MISSISSIPPI,Starkville,25711.0,72,58,14
3752,MISSISSIPPI,Summit,1533.0,8,7,1
3753,MISSISSIPPI,Sumrall,1984.0,7,6,1
3754,MISSISSIPPI,Union,1866.0,8,7,1
3755,MISSISSIPPI,Utica,895.0,2,2,0
3756,MISSISSIPPI,Vardaman,1254.0,1,1,0
3757,MISSISSIPPI,Walnut,733.0,4,4,0
3758,MISSISSIPPI,Waynesboro,4847.0,11,11,0
3759,MISSISSIPPI,West Point,10294.0,35,29,6
3760,MISSISSIPPI,Wiggins,4535.0,18,13,5
3761,MISSOURI,Adrian,1594.0,5,5,0
3762,MISSOURI,Ashland,4063.0,9,8,1
3763,MISSOURI,Ava,2897.0,12,7,5
3764,MISSOURI,Bella Villa,719.0,4,4,0
3765,MISSOURI,Bellefontaine Neighbors,10251.0,30,28,2
3766,MISSOURI,Belton,23860.0,67,49,18
3767,MISSOURI,Berkeley,8868.0,33,25,8
3768,MISSOURI,Bertrand,739.0,1,1,0
3769,MISSOURI,Bethany,3025.0,6,6,0
3770,MISSOURI,Bonne Terre,6811.0,10,10,0
3771,MISSOURI,Boonville,7833.0,28,21,7
3772,MISSOURI,Bourbon,1558.0,8,8,0
3773,MISSOURI,Branson,11797.0,65,45,20
3774,MISSOURI,Brentwood,7944.0,30,29,1
3775,MISSOURI,Buffalo,3214.0,7,6,1
3776,MISSOURI,Butler,3981.0,19,12,7
3777,MISSOURI,Cabool,2063.0,12,8,4
3778,MISSOURI,Calverton Park,1265.0,7,7,0
3779,MISSOURI,Camdenton,4186.0,17,15,2
3780,MISSOURI,Campbell,1773.0,7,7,0
3781,MISSOURI,Canton,2308.0,6,5,1
3782,MISSOURI,Cape Girardeau,41957.0,102,70,32
3783,MISSOURI,Caruthersville,5212.0,15,14,1
3784,MISSOURI,Centralia,4376.0,16,11,5
3785,MISSOURI,Chaffee,2895.0,12,7,5
3786,MISSOURI,Charleston,4936.0,18,12,6
3787,MISSOURI,Chillicothe,8865.0,27,17,10
3788,MISSOURI,Cleveland,669.0,2,2,0
3789,MISSOURI,Clinton,9047.0,25,24,1
3790,MISSOURI,Columbia,126418.0,208,162,46
3791,MISSOURI,Concordia,2367.0,9,9,0
3792,MISSOURI,Country Club Hills,1243.0,7,7,0
3793,MISSOURI,Cuba,3270.0,16,15,1
3794,MISSOURI,Des Peres,8757.0,48,42,6
3795,MISSOURI,Dexter,7833.0,25,18,7
3796,MISSOURI,Doniphan,1911.0,10,6,4
3797,MISSOURI,Duquesne,1681.0,4,3,1
3798,MISSOURI,East Prairie,2905.0,12,7,5
3799,MISSOURI,Edmundson,827.0,12,11,1
3800,MISSOURI,Eldon,4764.0,13,12,1
3801,MISSOURI,Ellisville,9905.0,33,32,1
3802,MISSOURI,Ellsinore,424.0,2,2,0
3803,MISSOURI,Eureka,11442.0,30,26,4
3804,MISSOURI,Excelsior Springs,11908.0,31,21,10
3805,MISSOURI,Ferguson,20386.0,41,30,11
3806,MISSOURI,Festus,12167.0,38,29,9
3807,MISSOURI,Flordell Hills,797.0,8,8,0
3808,MISSOURI,Florissant,50653.0,120,89,31
3809,MISSOURI,Fordland,861.0,1,1,0
3810,MISSOURI,Fredericktown,4008.0,14,13,1
3811,MISSOURI,Frontenac,3899.0,22,21,1
3812,MISSOURI,Fulton,12530.0,31,26,5
3813,MISSOURI,Galena,443.0,4,2,2
3814,MISSOURI,Gerald,1324.0,4,4,0
3815,MISSOURI,Gladstone,27905.0,55,38,17
3816,MISSOURI,Glendale,5856.0,12,11,1
3817,MISSOURI,Grain Valley,15038.0,29,24,5
3818,MISSOURI,Grandview,24734.0,69,51,18
3819,MISSOURI,Greenfield,1310.0,4,4,0
3820,MISSOURI,Hamilton,1680.0,7,7,0
3821,MISSOURI,Hannibal,17194.0,46,35,11
3822,MISSOURI,Harrisonville,10091.0,28,20,8
3823,MISSOURI,Hayti,2425.0,12,12,0
3824,MISSOURI,Hazelwood,24976.0,72,57,15
3825,MISSOURI,Higginsville,4639.0,22,10,12
3826,MISSOURI,Holts Summit,5296.0,8,7,1
3827,MISSOURI,Houston,2085.0,9,9,0
3828,MISSOURI,Independence,116761.0,267,191,76
3829,MISSOURI,Ironton,1378.0,7,7,0
3830,MISSOURI,Jackson,14792.0,32,31,1
3831,MISSOURI,Jefferson City,41851.0,122,87,35
3832,MISSOURI,Jonesburg,692.0,5,5,0
3833,MISSOURI,Kansas City,500965.0,1839,1286,553
3834,MISSOURI,Kearney,11467.0,20,18,2
3835,MISSOURI,Kennett,9946.0,25,19,6
3836,MISSOURI,Kimberling City,2321.0,4,4,0
3837,MISSOURI,Kirksville,17666.0,29,26,3
3838,MISSOURI,Ladue,8624.0,29,28,1
3839,MISSOURI,Lakeshire,1380.0,3,3,0
3840,MISSOURI,Lake St. Louis,17469.0,42,32,10
3841,MISSOURI,Lake Tapawingo,718.0,4,3,1
3842,MISSOURI,La Plata,1297.0,4,4,0
3843,MISSOURI,Laurie,983.0,5,5,0
3844,MISSOURI,Lebanon,14917.0,36,24,12
3845,MISSOURI,Lee's Summit,102519.0,187,134,53
3846,MISSOURI,Lexington,4526.0,10,8,2
3847,MISSOURI,Lincoln,1198.0,4,4,0
3848,MISSOURI,Lowry City,629.0,6,1,5
3849,MISSOURI,Macon,5327.0,11,9,2
3850,MISSOURI,Malden,3812.0,15,10,5
3851,MISSOURI,Manchester,18081.0,44,35,9
3852,MISSOURI,Maplewood,8076.0,34,33,1
3853,MISSOURI,Marionville,2157.0,4,4,0
3854,MISSOURI,Marshall,12868.0,30,23,7
3855,MISSOURI,Maryland Heights,26839.0,95,80,15
3856,MISSOURI,Maryville,11479.0,27,19,8
3857,MISSOURI,Merriam Woods,1870.0,1,1,0
3858,MISSOURI,Mexico,11531.0,29,28,1
3859,MISSOURI,Milan,1744.0,5,5,0
3860,MISSOURI,Moberly,13459.0,35,25,10
3861,MISSOURI,Monroe City,2433.0,6,5,1
3862,MISSOURI,Moscow Mills,3784.0,8,8,0
3863,MISSOURI,Mountain View,2649.0,7,5,2
3864,MISSOURI,New Florence,698.0,3,3,0
3865,MISSOURI,Niangua,426.0,1,1,0
3866,MISSOURI,Northmoor,364.0,10,10,0
3867,MISSOURI,Odessa,5293.0,13,11,2
3868,MISSOURI,Olivette,7850.0,22,21,1
3869,MISSOURI,Oronogo,2696.0,6,6,0
3870,MISSOURI,Osage Beach,4706.0,31,21,10
3871,MISSOURI,Owensville,2551.0,8,7,1
3872,MISSOURI,Palmyra,3574.0,9,8,1
3873,MISSOURI,Peculiar,5774.0,11,10,1
3874,MISSOURI,Perry,703.0,1,1,0
3875,MISSOURI,Perryville,8570.0,30,23,7
3876,MISSOURI,Piedmont,1868.0,5,5,0
3877,MISSOURI,Platte Woods,408.0,4,4,0
3878,MISSOURI,Pleasant Hill,8801.0,19,13,6
3879,MISSOURI,Pleasant Valley,3063.0,21,9,12
3880,MISSOURI,Poplar Bluff,16784.0,51,41,10
3881,MISSOURI,Prairie Home,280.0,1,1,0
3882,MISSOURI,Raymore,22885.0,42,26,16
3883,MISSOURI,Richland,1791.0,5,5,0
3884,MISSOURI,Rock Hill,4610.0,11,10,1
3885,MISSOURI,Rolla,20519.0,61,36,25
3886,MISSOURI,Salem,4866.0,16,11,5
3887,MISSOURI,Salisbury,1500.0,4,3,1
3888,MISSOURI,Sarcoxie,1546.0,6,6,0
3889,MISSOURI,Scott City,4520.0,17,12,5
3890,MISSOURI,Seligman,835.0,1,1,0
3891,MISSOURI,Seymour,2033.0,8,8,0
3892,MISSOURI,Sikeston,15931.0,68,50,18
3893,MISSOURI,Springfield,168988.0,386,309,77
3894,MISSOURI,St. Ann,12540.0,67,42,25
3895,MISSOURI,Steele,1825.0,4,4,0
3896,MISSOURI,Steelville,1636.0,6,6,0
3897,MISSOURI,St. James,3986.0,11,10,1
3898,MISSOURI,St. John,6299.0,18,17,1
3899,MISSOURI,St. Louis,295536.0,1537,1119,418
3900,MISSOURI,St. Peters,58597.0,123,96,27
3901,MISSOURI,St. Robert,6558.0,25,19,6
3902,MISSOURI,Sullivan,7118.0,26,19,7
3903,MISSOURI,Summersville,486.0,3,3,0
3904,MISSOURI,Sunset Hills,8447.0,31,25,6
3905,MISSOURI,Tarkio,1405.0,2,2,0
3906,MISSOURI,Thayer,2092.0,12,8,4
3907,MISSOURI,Trenton,5584.0,18,12,6
3908,MISSOURI,Union,12292.0,27,25,2
3909,MISSOURI,University City,33930.0,84,66,18
3910,MISSOURI,Van Buren,795.0,5,5,0
3911,MISSOURI,Versailles,2479.0,10,9,1
3912,MISSOURI,Viburnum,645.0,2,2,0
3913,MISSOURI,Vienna,599.0,2,2,0
3914,MISSOURI,Vinita Park,10910.0,48,46,2
3915,MISSOURI,Warrensburg,20707.0,32,28,4
3916,MISSOURI,Warson Woods,1890.0,8,8,0
3917,MISSOURI,Washington,14270.0,31,29,2
3918,MISSOURI,Waverly,846.0,1,1,0
3919,MISSOURI,Weatherby Lake,2125.0,12,12,0
3920,MISSOURI,Wellsville,1125.0,12,12,0
3921,MISSOURI,Weston,1854.0,9,9,0
3922,MISSOURI,West Plains,12417.0,39,31,8
3923,MISSOURI,Willard,5781.0,8,7,1
3924,MISSOURI,Willow Springs,2090.0,9,6,3
3925,MISSOURI,Winona,1292.0,2,2,0
3926,MISSOURI,Woodson Terrace,4028.0,18,16,2
3927,MISSOURI,Wright City,4654.0,17,15,2
3928,MONTANA,Baker,1910.0,4,4,0
3929,MONTANA,Belgrade,10738.0,21,17,4
3930,MONTANA,Billings,110274.0,185,154,31
3931,MONTANA,Bozeman,52586.0,73,64,9
3932,MONTANA,Bridger,775.0,3,3,0
3933,MONTANA,Chinook,1233.0,4,4,0
3934,MONTANA,Colstrip,2216.0,11,7,4
3935,MONTANA,Columbia Falls,6385.0,11,10,1
3936,MONTANA,Columbus,2141.0,6,5,1
3937,MONTANA,Conrad,2396.0,5,5,0
3938,MONTANA,Cut Bank,3028.0,6,5,1
3939,MONTANA,Deer Lodge,2772.0,6,6,0
3940,MONTANA,Dillon,4352.0,11,10,1
3941,MONTANA,East Helena,2140.0,1,1,0
3942,MONTANA,Ennis,1065.0,2,2,0
3943,MONTANA,Eureka,1449.0,3,3,0
3944,MONTANA,Fairview ,886.0,3,3,0
3945,MONTANA,Fort Benton,1440.0,4,4,0
3946,MONTANA,Glasgow,3318.0,11,7,4
3947,MONTANA,Glendive,4873.0,11,6,5
3948,MONTANA,Great Falls,58265.0,125,87,38
3949,MONTANA,Hamilton,5140.0,15,14,1
3950,MONTANA,Havre,9724.0,23,17,6
3951,MONTANA,Helena,34262.0,71,47,24
3952,MONTANA,Hot Springs,592.0,2,2,0
3953,MONTANA,Kalispell,25926.0,51,40,11
3954,MONTANA,Laurel,6710.0,19,13,6
3955,MONTANA,Lewistown,5882.0,18,13,5
3956,MONTANA,Libby,2867.0,6,6,0
3957,MONTANA,Livingston,7991.0,26,16,10
3958,MONTANA,Manhattan,1963.0,4,4,0
3959,MONTANA,Miles City,8160.0,17,17,0
3960,MONTANA,Missoula,77852.0,140,113,27
3961,MONTANA,Plains,1148.0,3,3,0
3962,MONTANA,Polson,5242.0,15,14,1
3963,MONTANA,Red Lodge,2384.0,5,5,0
3964,MONTANA,Ronan City,2195.0,6,6,0
3965,MONTANA,Sidney,6407.0,11,10,1
3966,MONTANA,Stevensville,2171.0,5,4,1
3967,MONTANA,St. Ignatius,846.0,2,2,0
3968,MONTANA,Thompson Falls,1443.0,4,4,0
3969,MONTANA,Troy,986.0,4,4,0
3970,MONTANA,West Yellowstone,1383.0,9,3,6
3971,MONTANA,Whitefish,8972.0,18,15,3
3972,MONTANA,Wolf Point,2734.0,8,6,2
3973,NEBRASKA,Alliance,7986.0,23,14,9
3974,NEBRASKA,Ashland,2752.0,5,4,1
3975,NEBRASKA,Aurora,4491.0,9,8,1
3976,NEBRASKA,Bayard,1069.0,4,4,0
3977,NEBRASKA,Beatrice,12225.0,37,21,16
3978,NEBRASKA,Bellevue,53436.0,116,104,12
3979,NEBRASKA,Bennington,1524.0,4,4,0
3980,NEBRASKA,Blair,7979.0,15,13,2
3981,NEBRASKA,Bloomfield,936.0,2,2,0
3982,NEBRASKA,Boys Town,306.0,10,10,0
3983,NEBRASKA,Broken Bow,3427.0,8,7,1
3984,NEBRASKA,Burwell,1158.0,1,1,0
3985,NEBRASKA,Central City,2887.0,6,5,1
3986,NEBRASKA,Chadron,5194.0,20,13,7
3987,NEBRASKA,Columbus,23727.0,42,36,6
3988,NEBRASKA,Cozad,3689.0,8,8,0
3989,NEBRASKA,Crete,6864.0,14,12,2
3990,NEBRASKA,Emerson,784.0,1,1,0
3991,NEBRASKA,Falls City,4052.0,12,8,4
3992,NEBRASKA,Franklin,889.0,2,2,0
3993,NEBRASKA,Fremont,26210.0,47,38,9
3994,NEBRASKA,Gering,8017.0,20,18,2
3995,NEBRASKA,Gordon,1475.0,8,6,2
3996,NEBRASKA,Gothenburg,3408.0,8,5,3
3997,NEBRASKA,Grand Island,51226.0,96,79,17
3998,NEBRASKA,Harvard,961.0,2,2,0
3999,NEBRASKA,Hastings,24680.0,52,38,14
4000,NEBRASKA,Hemingford,759.0,1,1,0
4001,NEBRASKA,Holdrege,5375.0,14,8,6
4002,NEBRASKA,Imperial,2005.0,3,3,0
4003,NEBRASKA,Kearney,34576.0,74,58,16
4004,NEBRASKA,Kimball,2261.0,5,4,1
4005,NEBRASKA,La Vista,17057.0,41,35,6
4006,NEBRASKA,Lexington,10099.0,22,20,2
4007,NEBRASKA,Lincoln,293808.0,490,354,136
4008,NEBRASKA,Madison,2337.0,3,3,0
4009,NEBRASKA,McCook,7478.0,22,15,7
4010,NEBRASKA,Milford,2006.0,3,3,0
4011,NEBRASKA,Minden,3031.0,6,6,0
4012,NEBRASKA,Morrill,869.0,2,2,0
4013,NEBRASKA,Nebraska City,7248.0,14,13,1
4014,NEBRASKA,Neligh,1478.0,2,2,0
4015,NEBRASKA,Norfolk,24370.0,60,40,20
4016,NEBRASKA,North Platte,23057.0,62,40,22
4017,NEBRASKA,Omaha,480307.0,1044,895,149
4018,NEBRASKA,O'Neill,3521.0,8,7,1
4019,NEBRASKA,Ord,2043.0,3,3,0
4020,NEBRASKA,Papillion,20313.0,49,45,4
4021,NEBRASKA,Pierce,1731.0,3,3,0
4022,NEBRASKA,Plattsmouth,6409.0,17,14,3
4023,NEBRASKA,Ralston,7386.0,15,14,1
4024,NEBRASKA,Ravenna,1361.0,2,2,0
4025,NEBRASKA,Scottsbluff,15463.0,34,29,5
4026,NEBRASKA,Scribner,776.0,1,1,0
4027,NEBRASKA,Seward,7402.0,13,12,1
4028,NEBRASKA,Sidney,6186.0,12,10,2
4029,NEBRASKA,South Sioux City,12780.0,28,27,1
4030,NEBRASKA,St. Paul,2336.0,4,4,0
4031,NEBRASKA,Superior,1790.0,4,3,1
4032,NEBRASKA,Sutton,1441.0,3,3,0
4033,NEBRASKA,Tekamah,1703.0,5,5,0
4034,NEBRASKA,Tilden,934.0,1,1,0
4035,NEBRASKA,Valentine,2747.0,6,5,1
4036,NEBRASKA,Valley,2985.0,5,5,0
4037,NEBRASKA,Wahoo,4611.0,6,6,0
4038,NEBRASKA,Waterloo,921.0,4,4,0
4039,NEBRASKA,Wayne,5766.0,12,8,4
4040,NEBRASKA,West Point,3223.0,5,4,1
4041,NEBRASKA,Wymore,1311.0,4,4,0
4042,NEVADA,Boulder City,16556.0,54,37,17
4043,NEVADA,Carlin,2273.0,7,5,2
4044,NEVADA,Elko,20760.0,46,39,7
4045,NEVADA,Fallon,8765.0,37,25,12
4046,NEVADA,Henderson,337375.0,642,469,173
4047,NEVADA,Las Vegas Metropolitan Police Department,1685021.0,5760,3994,1766
4048,NEVADA,Mesquite,21038.0,54,38,16
4049,NEVADA,Reno,262919.0,453,327,126
4050,NEVADA,Winnemucca,7835.0,29,24,5
4051,NEVADA,Yerington,3267.0,8,7,1
4052,NEW HAMPSHIRE,Alexandria,1629.0,2,2,0
4053,NEW HAMPSHIRE,Allenstown,4505.0,9,7,2
4054,NEW HAMPSHIRE,Alstead,1952.0,2,2,0
4055,NEW HAMPSHIRE,Alton,5445.0,14,12,2
4056,NEW HAMPSHIRE,Amherst,11440.0,19,18,1
4057,NEW HAMPSHIRE,Andover,2392.0,2,2,0
4058,NEW HAMPSHIRE,Antrim,2687.0,5,5,0
4059,NEW HAMPSHIRE,Ashland,2066.0,5,5,0
4060,NEW HAMPSHIRE,Atkinson,7296.0,9,8,1
4061,NEW HAMPSHIRE,Auburn,5771.0,12,10,2
4062,NEW HAMPSHIRE,Barnstead,4852.0,7,7,0
4063,NEW HAMPSHIRE,Barrington,9423.0,11,10,1
4064,NEW HAMPSHIRE,Bartlett,2818.0,4,4,0
4065,NEW HAMPSHIRE,Bedford,23137.0,48,36,12
4066,NEW HAMPSHIRE,Belmont,7406.0,17,14,3
4067,NEW HAMPSHIRE,Bennington,1520.0,2,2,0
4068,NEW HAMPSHIRE,Berlin,9799.0,30,22,8
4069,NEW HAMPSHIRE,Bethlehem,2669.0,6,6,0
4070,NEW HAMPSHIRE,Boscawen,4110.0,7,6,1
4071,NEW HAMPSHIRE,Bow,8119.0,12,11,1
4072,NEW HAMPSHIRE,Bradford,1748.0,4,4,0
4073,NEW HAMPSHIRE,Brentwood,4682.0,2,2,0
4074,NEW HAMPSHIRE,Bristol,3168.0,10,9,1
4075,NEW HAMPSHIRE,Brookline,5547.0,10,9,1
4076,NEW HAMPSHIRE,Campton,3335.0,7,5,2
4077,NEW HAMPSHIRE,Canaan,3914.0,6,5,1
4078,NEW HAMPSHIRE,Candia,4016.0,8,7,1
4079,NEW HAMPSHIRE,Canterbury,2510.0,3,3,0
4080,NEW HAMPSHIRE,Carroll,754.0,4,4,0
4081,NEW HAMPSHIRE,Center Harbor,1112.0,4,4,0
4082,NEW HAMPSHIRE,Charlestown,5023.0,9,5,4
4083,NEW HAMPSHIRE,Chester,5399.0,9,8,1
4084,NEW HAMPSHIRE,Chesterfield,3648.0,6,5,1
4085,NEW HAMPSHIRE,Chichester,2750.0,5,5,0
4086,NEW HAMPSHIRE,Claremont,12905.0,29,21,8
4087,NEW HAMPSHIRE,Colebrook,2118.0,4,4,0
4088,NEW HAMPSHIRE,Concord,44053.0,97,86,11
4089,NEW HAMPSHIRE,Conway,10364.0,32,23,9
4090,NEW HAMPSHIRE,Danville,4677.0,5,5,0
4091,NEW HAMPSHIRE,Deerfield,4652.0,9,8,1
4092,NEW HAMPSHIRE,Deering,1974.0,2,2,0
4093,NEW HAMPSHIRE,Derry,33892.0,67,54,13
4094,NEW HAMPSHIRE,Dover,33112.0,66,45,21
4095,NEW HAMPSHIRE,Dublin,1552.0,3,2,1
4096,NEW HAMPSHIRE,Dunbarton,2934.0,6,6,0
4097,NEW HAMPSHIRE,Durham,16848.0,22,19,3
4098,NEW HAMPSHIRE,East Kingston,2446.0,6,5,1
4099,NEW HAMPSHIRE,Effingham,1483.0,2,2,0
4100,NEW HAMPSHIRE,Enfield,4563.0,7,6,1
4101,NEW HAMPSHIRE,Epping,7233.0,16,15,1
4102,NEW HAMPSHIRE,Epsom,4848.0,7,6,1
4103,NEW HAMPSHIRE,Exeter,15596.0,32,24,8
4104,NEW HAMPSHIRE,Farmington,7058.0,12,11,1
4105,NEW HAMPSHIRE,Fitzwilliam,2373.0,4,3,1
4106,NEW HAMPSHIRE,Francestown,1584.0,1,1,0
4107,NEW HAMPSHIRE,Franconia,1117.0,4,4,0
4108,NEW HAMPSHIRE,Franklin,8782.0,25,17,8
4109,NEW HAMPSHIRE,Freedom,1603.0,2,2,0
4110,NEW HAMPSHIRE,Fremont,4847.0,7,6,1
4111,NEW HAMPSHIRE,Gilford,7391.0,24,18,6
4112,NEW HAMPSHIRE,Gilmanton,3850.0,6,5,1
4113,NEW HAMPSHIRE,Goffstown,18184.0,45,31,14
4114,NEW HAMPSHIRE,Gorham,2569.0,10,6,4
4115,NEW HAMPSHIRE,Grafton,1337.0,1,1,0
4116,NEW HAMPSHIRE,Grantham,2953.0,6,5,1
4117,NEW HAMPSHIRE,Greenland,4228.0,10,9,1
4118,NEW HAMPSHIRE,Greenville,2111.0,3,3,0
4119,NEW HAMPSHIRE,Hampstead,8733.0,9,9,0
4120,NEW HAMPSHIRE,Hampton,16206.0,42,35,7
4121,NEW HAMPSHIRE,Hampton Falls,2459.0,5,5,0
4122,NEW HAMPSHIRE,Hancock,1650.0,2,2,0
4123,NEW HAMPSHIRE,Hanover,11586.0,28,18,10
4124,NEW HAMPSHIRE,Harrisville,953.0,1,1,0
4125,NEW HAMPSHIRE,Haverhill,4542.0,7,5,2
4126,NEW HAMPSHIRE,Hebron,635.0,1,1,0
4127,NEW HAMPSHIRE,Henniker,5024.0,9,8,1
4128,NEW HAMPSHIRE,Hillsborough,6020.0,23,15,8
4129,NEW HAMPSHIRE,Hinsdale,3894.0,7,6,1
4130,NEW HAMPSHIRE,Holderness,2133.0,6,6,0
4131,NEW HAMPSHIRE,Hollis,8166.0,18,16,2
4132,NEW HAMPSHIRE,Hooksett,14834.0,41,30,11
4133,NEW HAMPSHIRE,Hopkinton,5852.0,5,4,1
4134,NEW HAMPSHIRE,Hudson,25736.0,67,50,17
4135,NEW HAMPSHIRE,Jackson,869.0,4,4,0
4136,NEW HAMPSHIRE,Jaffrey,5271.0,11,10,1
4137,NEW HAMPSHIRE,Keene,22619.0,49,39,10
4138,NEW HAMPSHIRE,Kensington,2116.0,7,6,1
4139,NEW HAMPSHIRE,Kingston,6549.0,7,6,1
4140,NEW HAMPSHIRE,Laconia,16929.0,54,43,11
4141,NEW HAMPSHIRE,Lancaster,3209.0,6,4,2
4142,NEW HAMPSHIRE,Lebanon,13877.0,44,32,12
4143,NEW HAMPSHIRE,Lee,4684.0,10,9,1
4144,NEW HAMPSHIRE,Lincoln,1787.0,16,11,5
4145,NEW HAMPSHIRE,Lisbon,1586.0,4,4,0
4146,NEW HAMPSHIRE,Litchfield,8696.0,15,13,2
4147,NEW HAMPSHIRE,Littleton,5898.0,16,13,3
4148,NEW HAMPSHIRE,Londonderry,27268.0,73,58,15
4149,NEW HAMPSHIRE,Loudon,5740.0,7,6,1
4150,NEW HAMPSHIRE,Lyme,1682.0,2,2,0
4151,NEW HAMPSHIRE,Madison,2646.0,4,4,0
4152,NEW HAMPSHIRE,Manchester,112844.0,269,222,47
4153,NEW HAMPSHIRE,Marlborough,2089.0,2,2,0
4154,NEW HAMPSHIRE,Mason,1438.0,2,2,0
4155,NEW HAMPSHIRE,Meredith,6579.0,17,13,4
4156,NEW HAMPSHIRE,Merrimack,27656.0,52,39,13
4157,NEW HAMPSHIRE,Middleton,1859.0,4,4,0
4158,NEW HAMPSHIRE,Milford,16662.0,30,25,5
4159,NEW HAMPSHIRE,Milton,4676.0,7,6,1
4160,NEW HAMPSHIRE,Mont Vernon,2749.0,4,3,1
4161,NEW HAMPSHIRE,Moultonborough,4227.0,9,8,1
4162,NEW HAMPSHIRE,Nashua,89431.0,229,172,57
4163,NEW HAMPSHIRE,New Boston,6006.0,8,7,1
4164,NEW HAMPSHIRE,Newbury,2263.0,5,5,0
4165,NEW HAMPSHIRE,New Castle,985.0,4,4,0
4166,NEW HAMPSHIRE,New Durham,2771.0,5,5,0
4167,NEW HAMPSHIRE,Newfields,1760.0,2,2,0
4168,NEW HAMPSHIRE,New Hampton,2270.0,5,4,1
4169,NEW HAMPSHIRE,Newington,849.0,11,10,1
4170,NEW HAMPSHIRE,New Ipswich,5462.0,5,4,1
4171,NEW HAMPSHIRE,New London,4257.0,14,9,5
4172,NEW HAMPSHIRE,Newmarket,9349.0,20,13,7
4173,NEW HAMPSHIRE,Newport,6366.0,16,11,5
4174,NEW HAMPSHIRE,Newton,5030.0,8,7,1
4175,NEW HAMPSHIRE,Northfield,4995.0,9,9,0
4176,NEW HAMPSHIRE,North Hampton,4562.0,13,12,1
4177,NEW HAMPSHIRE,Northumberland,2101.0,4,4,0
4178,NEW HAMPSHIRE,Northwood,4385.0,8,7,1
4179,NEW HAMPSHIRE,Nottingham,5281.0,9,8,1
4180,NEW HAMPSHIRE,Orford,1323.0,1,1,0
4181,NEW HAMPSHIRE,Ossipee,4387.0,9,8,1
4182,NEW HAMPSHIRE,Pelham,14453.0,31,23,8
4183,NEW HAMPSHIRE,Pembroke,7265.0,12,10,2
4184,NEW HAMPSHIRE,Peterborough,6792.0,14,12,2
4185,NEW HAMPSHIRE,Piermont,821.0,1,1,0
4186,NEW HAMPSHIRE,Pittsburg,817.0,1,1,0
4187,NEW HAMPSHIRE,Pittsfield,4146.0,7,7,0
4188,NEW HAMPSHIRE,Plainfield,2425.0,3,3,0
4189,NEW HAMPSHIRE,Plaistow,7847.0,22,15,7
4190,NEW HAMPSHIRE,Plymouth,6911.0,18,11,7
4191,NEW HAMPSHIRE,Portsmouth,21913.0,84,65,19
4192,NEW HAMPSHIRE,Raymond,10752.0,25,17,8
4193,NEW HAMPSHIRE,Rindge,6142.0,10,9,1
4194,NEW HAMPSHIRE,Rochester,32327.0,65,51,14
4195,NEW HAMPSHIRE,Rollinsford,2615.0,5,5,0
4196,NEW HAMPSHIRE,Rumney,1585.0,1,1,0
4197,NEW HAMPSHIRE,Rye,5566.0,11,10,1
4198,NEW HAMPSHIRE,Salem,31231.0,79,64,15
4199,NEW HAMPSHIRE,Sanbornton,3055.0,7,6,1
4200,NEW HAMPSHIRE,Sandown,6693.0,9,8,1
4201,NEW HAMPSHIRE,Sandwich,1371.0,2,2,0
4202,NEW HAMPSHIRE,Seabrook,8974.0,34,28,6
4203,NEW HAMPSHIRE,Somersworth,12498.0,32,25,7
4204,NEW HAMPSHIRE,South Hampton,835.0,3,3,0
4205,NEW HAMPSHIRE,Springfield,1351.0,2,2,0
4206,NEW HAMPSHIRE,Strafford,4314.0,5,5,0
4207,NEW HAMPSHIRE,Stratham,7707.0,12,11,1
4208,NEW HAMPSHIRE,Sugar Hill,586.0,2,2,0
4209,NEW HAMPSHIRE,Sunapee,3519.0,6,5,1
4210,NEW HAMPSHIRE,Sutton,1945.0,2,2,0
4211,NEW HAMPSHIRE,Swanzey,7275.0,11,10,1
4212,NEW HAMPSHIRE,Tamworth,3117.0,2,2,0
4213,NEW HAMPSHIRE,Thornton,2559.0,6,5,1
4214,NEW HAMPSHIRE,Tilton,3602.0,18,13,5
4215,NEW HAMPSHIRE,Troy,2114.0,2,2,0
4216,NEW HAMPSHIRE,Tuftonboro,2443.0,4,4,0
4217,NEW HAMPSHIRE,Wakefield,5812.0,13,11,2
4218,NEW HAMPSHIRE,Walpole,4064.0,5,4,1
4219,NEW HAMPSHIRE,Warner,2964.0,3,2,1
4220,NEW HAMPSHIRE,Warren,952.0,1,1,0
4221,NEW HAMPSHIRE,Washington,1102.0,1,1,0
4222,NEW HAMPSHIRE,Waterville Valley,242.0,7,7,0
4223,NEW HAMPSHIRE,Weare,9130.0,13,12,1
4224,NEW HAMPSHIRE,Webster,1983.0,2,2,0
4225,NEW HAMPSHIRE,Whitefield,2186.0,7,6,1
4226,NEW HAMPSHIRE,Wilmot,1412.0,1,1,0
4227,NEW HAMPSHIRE,Wilton,3854.0,9,8,1
4228,NEW HAMPSHIRE,Winchester,4205.0,5,4,1
4229,NEW HAMPSHIRE,Windham,15191.0,28,21,7
4230,NEW HAMPSHIRE,Wolfeboro,6467.0,20,14,6
4231,NEW HAMPSHIRE,Woodstock,1373.0,3,3,0
4232,NEW JERSEY,Aberdeen Township,19475.0,49,42,7
4233,NEW JERSEY,Absecon,8820.0,28,27,1
4234,NEW JERSEY,Allendale,7003.0,21,16,5
4235,NEW JERSEY,Allenhurst,482.0,12,9,3
4236,NEW JERSEY,Allentown,1756.0,7,6,1
4237,NEW JERSEY,Alpine,1921.0,12,12,0
4238,NEW JERSEY,Andover Township,5805.0,17,12,5
4239,NEW JERSEY,Asbury Park,15305.0,90,86,4
4240,NEW JERSEY,Atlantic City,37379.0,366,257,109
4241,NEW JERSEY,Atlantic Highlands,4359.0,16,15,1
4242,NEW JERSEY,Audubon,8959.0,18,17,1
4243,NEW JERSEY,Avalon,1208.0,24,21,3
4244,NEW JERSEY,Avon-by-the-Sea,1772.0,12,12,0
4245,NEW JERSEY,Barnegat Township,25395.0,55,53,2
4246,NEW JERSEY,Barrington,6849.0,18,16,2
4247,NEW JERSEY,Bay Head,1028.0,10,9,1
4248,NEW JERSEY,Bayonne,68121.0,230,178,52
4249,NEW JERSEY,Beach Haven,1275.0,14,13,1
4250,NEW JERSEY,Beachwood,11988.0,21,19,2
4251,NEW JERSEY,Bedminster Township,8290.0,18,16,2
4252,NEW JERSEY,Belleville,38053.0,111,106,5
4253,NEW JERSEY,Bellmawr,11778.0,25,24,1
4254,NEW JERSEY,Belmar,5514.0,31,25,6
4255,NEW JERSEY,Belvidere,2552.0,6,5,1
4256,NEW JERSEY,Bergenfield,28578.0,52,44,8
4257,NEW JERSEY,Berkeley Heights Township,13892.0,32,29,3
4258,NEW JERSEY,Berkeley Township,44366.0,99,77,22
4259,NEW JERSEY,Berlin,7817.0,18,17,1
4260,NEW JERSEY,Berlin Township,6152.0,19,18,1
4261,NEW JERSEY,Bernards Township,28288.0,42,38,4
4262,NEW JERSEY,Bernardsville,7883.0,30,24,6
4263,NEW JERSEY,Beverly,2473.0,8,8,0
4264,NEW JERSEY,Blairstown Township,5679.0,10,9,1
4265,NEW JERSEY,Bloomfield,52181.0,147,123,24
4266,NEW JERSEY,Bloomingdale,8415.0,19,18,1
4267,NEW JERSEY,Bogota,8658.0,26,21,5
4268,NEW JERSEY,Boonton,9312.0,23,22,1
4269,NEW JERSEY,Boonton Township,4393.0,15,14,1
4270,NEW JERSEY,Bordentown City,3782.0,14,14,0
4271,NEW JERSEY,Bordentown Township,12134.0,31,27,4
4272,NEW JERSEY,Bound Brook,10594.0,33,27,6
4273,NEW JERSEY,Bradley Beach,4114.0,22,18,4
4274,NEW JERSEY,Branchburg Township,15172.0,30,27,3
4275,NEW JERSEY,Brick Township,80505.0,213,145,68
4276,NEW JERSEY,Bridgeton,23472.0,77,64,13
4277,NEW JERSEY,Bridgewater Township,45918.0,82,74,8
4278,NEW JERSEY,Brielle,4652.0,19,18,1
4279,NEW JERSEY,Brigantine,8495.0,45,35,10
4280,NEW JERSEY,Brooklawn,1969.0,8,8,0
4281,NEW JERSEY,Burlington City,9831.0,35,31,4
4282,NEW JERSEY,Burlington Township,22635.0,53,44,9
4283,NEW JERSEY,Butler,7965.0,17,16,1
4284,NEW JERSEY,Byram Township,7839.0,15,15,0
4285,NEW JERSEY,Caldwell,8284.0,18,18,0
4286,NEW JERSEY,Camden County Police Department,76544.0,399,368,31
4287,NEW JERSEY,Cape May,3384.0,23,22,1
4288,NEW JERSEY,Carlstadt,6365.0,28,26,2
4289,NEW JERSEY,Carney's Point Township,7656.0,21,20,1
4290,NEW JERSEY,Carteret,24427.0,71,68,3
4291,NEW JERSEY,Cedar Grove Township,13377.0,32,31,1
4292,NEW JERSEY,Chatham,8924.0,26,22,4
4293,NEW JERSEY,Chatham Township,10500.0,23,21,2
4294,NEW JERSEY,Cherry Hill Township,75214.0,163,134,29
4295,NEW JERSEY,Chesilhurst,1676.0,12,11,1
4296,NEW JERSEY,Chesterfield Township,7570.0,11,10,1
4297,NEW JERSEY,Chester Township,7917.0,24,23,1
4298,NEW JERSEY,Cinnaminson Township,16708.0,27,27,0
4299,NEW JERSEY,Clark Township,16622.0,56,45,11
4300,NEW JERSEY,Clayton,9190.0,17,16,1
4301,NEW JERSEY,Clementon,5157.0,14,13,1
4302,NEW JERSEY,Cliffside Park,27363.0,44,42,2
4303,NEW JERSEY,Clifton,88703.0,197,159,38
4304,NEW JERSEY,Clinton,2671.0,12,12,0
4305,NEW JERSEY,Clinton Township,12820.0,27,26,1
4306,NEW JERSEY,Closter,8804.0,25,24,1
4307,NEW JERSEY,Collingswood,14425.0,31,27,4
4308,NEW JERSEY,Colts Neck Township,9811.0,29,27,2
4309,NEW JERSEY,Cranbury Township,4361.0,20,19,1
4310,NEW JERSEY,Cranford Township,25189.0,66,52,14
4311,NEW JERSEY,Cresskill,8998.0,31,26,5
4312,NEW JERSEY,Deal,718.0,22,18,4
4313,NEW JERSEY,Delanco Township,4441.0,14,13,1
4314,NEW JERSEY,Delaware Township,4394.0,8,7,1
4315,NEW JERSEY,Delran Township,16431.0,33,29,4
4316,NEW JERSEY,Demarest,5033.0,15,15,0
4317,NEW JERSEY,Denville Township,17019.0,41,33,8
4318,NEW JERSEY,Deptford Township,31675.0,74,69,5
4319,NEW JERSEY,Dover,18306.0,38,34,4
4320,NEW JERSEY,Dumont,18340.0,40,31,9
4321,NEW JERSEY,Dunellen,7434.0,19,19,0
4322,NEW JERSEY,Eastampton Township,6145.0,21,20,1
4323,NEW JERSEY,East Brunswick Township,50438.0,109,84,25
4324,NEW JERSEY,East Greenwich Township,11587.0,24,22,2
4325,NEW JERSEY,East Hanover Township,11296.0,38,34,4
4326,NEW JERSEY,East Newark,2704.0,7,7,0
4327,NEW JERSEY,East Orange,67392.0,267,205,62
4328,NEW JERSEY,East Rutherford,10134.0,41,40,1
4329,NEW JERSEY,East Windsor Township,28325.0,46,42,4
4330,NEW JERSEY,Eatontown,12100.0,51,39,12
4331,NEW JERSEY,Edgewater,15346.0,32,29,3
4332,NEW JERSEY,Edgewater Park Township,8612.0,18,16,2
4333,NEW JERSEY,Edison Township,102726.0,231,181,50
4334,NEW JERSEY,Egg Harbor City,4038.0,14,13,1
4335,NEW JERSEY,Egg Harbor Township,41966.0,125,92,33
4336,NEW JERSEY,Elizabeth,134131.0,432,331,101
4337,NEW JERSEY,Elk Township,4348.0,12,11,1
4338,NEW JERSEY,Elmer,1304.0,2,2,0
4339,NEW JERSEY,Elmwood Park,20738.0,54,48,6
4340,NEW JERSEY,Emerson,7900.0,24,21,3
4341,NEW JERSEY,Englewood,29592.0,103,75,28
4342,NEW JERSEY,Englewood Cliffs,5544.0,26,25,1
4343,NEW JERSEY,Englishtown,1916.0,7,7,0
4344,NEW JERSEY,Essex Fells,2154.0,13,13,0
4345,NEW JERSEY,Evesham Township,45137.0,103,93,10
4346,NEW JERSEY,Ewing Township,38055.0,95,77,18
4347,NEW JERSEY,"Fairfield Township, Essex County",7775.0,47,43,4
4348,NEW JERSEY,Fair Haven,5671.0,13,13,0
4349,NEW JERSEY,Fair Lawn,34311.0,71,61,10
4350,NEW JERSEY,Fairview,14747.0,36,33,3
4351,NEW JERSEY,Fanwood,8092.0,18,16,2
4352,NEW JERSEY,Far Hills,940.0,7,6,1
4353,NEW JERSEY,Flemington,4549.0,16,16,0
4354,NEW JERSEY,Florence Township,12508.0,32,30,2
4355,NEW JERSEY,Florham Park,12322.0,38,32,6
4356,NEW JERSEY,Fort Lee,40285.0,117,96,21
4357,NEW JERSEY,Franklin,4662.0,17,16,1
4358,NEW JERSEY,Franklin Lakes,11744.0,29,24,5
4359,NEW JERSEY,"Franklin Township, Gloucester County",16980.0,42,38,4
4360,NEW JERSEY,"Franklin Township, Hunterdon County",3532.0,6,6,0
4361,NEW JERSEY,"Franklin Township, Somerset County",69423.0,124,103,21
4362,NEW JERSEY,Freehold Borough,11621.0,34,30,4
4363,NEW JERSEY,Freehold Township,34533.0,70,66,4
4364,NEW JERSEY,Frenchtown,1345.0,4,3,1
4365,NEW JERSEY,Galloway Township,35320.0,91,63,28
4366,NEW JERSEY,Garfield,33092.0,71,60,11
4367,NEW JERSEY,Garwood,4517.0,20,16,4
4368,NEW JERSEY,Gibbsboro,2293.0,7,7,0
4369,NEW JERSEY,Glassboro,21442.0,56,50,6
4370,NEW JERSEY,Glen Ridge,7896.0,29,23,6
4371,NEW JERSEY,Glen Rock,12153.0,26,24,2
4372,NEW JERSEY,Gloucester City,11637.0,35,33,2
4373,NEW JERSEY,Gloucester Township,66365.0,156,135,21
4374,NEW JERSEY,Green Brook Township,7307.0,23,22,1
4375,NEW JERSEY,"Greenwich Township, Gloucester County",5006.0,22,20,2
4376,NEW JERSEY,"Greenwich Township, Warren County",5428.0,12,12,0
4377,NEW JERSEY,Guttenberg,11458.0,32,26,6
4378,NEW JERSEY,Hackensack,45932.0,119,102,17
4379,NEW JERSEY,Hackettstown,9338.0,20,19,1
4380,NEW JERSEY,Haddonfield,11772.0,25,22,3
4381,NEW JERSEY,Haddon Heights,7829.0,18,17,1
4382,NEW JERSEY,Haddon Township,15104.0,28,27,1
4383,NEW JERSEY,Haledon,8604.0,21,21,0
4384,NEW JERSEY,Hamburg,3101.0,12,11,1
4385,NEW JERSEY,"Hamilton Township, Atlantic County",25718.0,69,53,16
4386,NEW JERSEY,"Hamilton Township, Mercer County",90195.0,203,171,32
4387,NEW JERSEY,Hammonton,13819.0,41,35,6
4388,NEW JERSEY,Hanover Township,14814.0,38,31,7
4389,NEW JERSEY,Harding Township,3904.0,18,17,1
4390,NEW JERSEY,Hardyston Township,7718.0,26,20,6
4391,NEW JERSEY,Harrington Park,4893.0,11,11,0
4392,NEW JERSEY,Harrison,22252.0,54,45,9
4393,NEW JERSEY,Harrison Township,13772.0,24,23,1
4394,NEW JERSEY,Harvey Cedars,365.0,9,9,0
4395,NEW JERSEY,Hasbrouck Heights,12415.0,30,28,2
4396,NEW JERSEY,Haworth,3516.0,13,12,1
4397,NEW JERSEY,Hawthorne,19442.0,41,35,6
4398,NEW JERSEY,Hazlet Township,19575.0,48,45,3
4399,NEW JERSEY,High Bridge,3364.0,9,9,0
4400,NEW JERSEY,Highland Park,14126.0,34,26,8
4401,NEW JERSEY,Highlands,4662.0,16,14,2
4402,NEW JERSEY,Hightstown,5473.0,14,13,1
4403,NEW JERSEY,Hillsborough Township,42116.0,62,54,8
4404,NEW JERSEY,Hillsdale,10692.0,19,18,1
4405,NEW JERSEY,Hillside Township,22799.0,76,63,13
4406,NEW JERSEY,Hi-Nella,891.0,10,10,0
4407,NEW JERSEY,Hoboken,55632.0,157,139,18
4408,NEW JERSEY,Ho-Ho-Kus,4217.0,21,16,5
4409,NEW JERSEY,Holland Township,5054.0,8,7,1
4410,NEW JERSEY,Holmdel Township,16659.0,52,43,9
4411,NEW JERSEY,Hopatcong,14051.0,47,39,8
4412,NEW JERSEY,Hopewell Township,18348.0,39,30,9
4413,NEW JERSEY,Howell Township,52098.0,108,93,15
4414,NEW JERSEY,Independence Township,5391.0,11,10,1
4415,NEW JERSEY,Irvington,56559.0,211,156,55
4416,NEW JERSEY,Island Heights,1773.0,7,7,0
4417,NEW JERSEY,Jackson Township,61350.0,124,106,18
4418,NEW JERSEY,Jamesburg,6058.0,20,16,4
4419,NEW JERSEY,Jefferson Township,21409.0,44,36,8
4420,NEW JERSEY,Jersey City,275213.0,1444,934,510
4421,NEW JERSEY,Keansburg,9568.0,40,33,7
4422,NEW JERSEY,Kearny,42183.0,111,105,6
4423,NEW JERSEY,Kenilworth,8520.0,31,26,5
4424,NEW JERSEY,Keyport,6925.0,24,22,2
4425,NEW JERSEY,Kinnelon,10239.0,17,16,1
4426,NEW JERSEY,Lacey Township,31324.0,59,44,15
4427,NEW JERSEY,Lakehurst,2862.0,13,11,2
4428,NEW JERSEY,Lakewood Township,113868.0,188,148,40
4429,NEW JERSEY,Lambertville,3777.0,11,9,2
4430,NEW JERSEY,Laurel Springs,1935.0,7,7,0
4431,NEW JERSEY,Lavallette,1992.0,16,12,4
4432,NEW JERSEY,Lawnside,2989.0,8,8,0
4433,NEW JERSEY,"Lawrence Township, Mercer County",33882.0,66,60,6
4434,NEW JERSEY,Lebanon Township,6030.0,11,10,1
4435,NEW JERSEY,Leonia,9370.0,24,21,3
4436,NEW JERSEY,Lincoln Park,10439.0,30,24,6
4437,NEW JERSEY,Linden,44010.0,180,136,44
4438,NEW JERSEY,Lindenwold,17897.0,46,43,3
4439,NEW JERSEY,Linwood,6592.0,22,20,2
4440,NEW JERSEY,Little Egg Harbor Township,23203.0,58,45,13
4441,NEW JERSEY,Little Falls Township,15019.0,38,29,9
4442,NEW JERSEY,Little Ferry,11144.0,30,25,5
4443,NEW JERSEY,Little Silver,5752.0,24,19,5
4444,NEW JERSEY,Livingston Township,31787.0,85,70,15
4445,NEW JERSEY,Lodi,25235.0,50,47,3
4446,NEW JERSEY,Logan Township,6118.0,24,23,1
4447,NEW JERSEY,Long Beach Township,3211.0,48,36,12
4448,NEW JERSEY,Long Branch,30148.0,116,92,24
4449,NEW JERSEY,Long Hill Township,8701.0,25,23,2
4450,NEW JERSEY,Longport,840.0,13,13,0
4451,NEW JERSEY,Lopatcong Township,8561.0,17,16,1
4452,NEW JERSEY,Lower Alloways Creek Township,1652.0,11,11,0
4453,NEW JERSEY,Lower Township,21042.0,57,51,6
4454,NEW JERSEY,Lumberton Township,12146.0,25,23,2
4455,NEW JERSEY,Lyndhurst Township,23987.0,57,54,3
4456,NEW JERSEY,Madison,18563.0,36,28,8
4457,NEW JERSEY,Magnolia,4435.0,17,17,0
4458,NEW JERSEY,Mahwah Township,27195.0,62,53,9
4459,NEW JERSEY,Manalapan Township,39240.0,62,58,4
4460,NEW JERSEY,Manasquan,5778.0,22,17,5
4461,NEW JERSEY,Manchester Township,46188.0,122,70,52
4462,NEW JERSEY,"Mansfield Township, Burlington County",8523.0,14,13,1
4463,NEW JERSEY,"Mansfield Township, Warren County",7354.0,16,15,1
4464,NEW JERSEY,Mantoloking,258.0,10,9,1
4465,NEW JERSEY,Mantua Township,15458.0,29,27,2
4466,NEW JERSEY,Manville,10473.0,27,24,3
4467,NEW JERSEY,Maple Shade Township,18395.0,41,37,4
4468,NEW JERSEY,Maplewood Township,27320.0,75,63,12
4469,NEW JERSEY,Margate City,5749.0,38,29,9
4470,NEW JERSEY,Marlboro Township,39580.0,110,84,26
4471,NEW JERSEY,Matawan,8579.0,25,24,1
4472,NEW JERSEY,Maywood,9970.0,26,22,4
4473,NEW JERSEY,Medford Lakes,3888.0,11,10,1
4474,NEW JERSEY,Medford Township,23417.0,40,36,4
4475,NEW JERSEY,Mendham,5023.0,13,12,1
4476,NEW JERSEY,Mendham Township,5845.0,16,15,1
4477,NEW JERSEY,Merchantville,3839.0,16,14,2
4478,NEW JERSEY,Metuchen,15521.0,34,29,5
4479,NEW JERSEY,Middlesex Borough,14101.0,28,25,3
4480,NEW JERSEY,Middle Township,18041.0,70,57,13
4481,NEW JERSEY,Middletown Township,65057.0,121,111,10
4482,NEW JERSEY,Midland Park,7481.0,18,17,1
4483,NEW JERSEY,Millburn Township,20949.0,64,58,6
4484,NEW JERSEY,Milltown,7203.0,19,16,3
4485,NEW JERSEY,Millville,26882.0,95,83,12
4486,NEW JERSEY,Monmouth Beach,3261.0,13,12,1
4487,NEW JERSEY,"Monroe Township, Gloucester County",38685.0,69,64,5
4488,NEW JERSEY,"Monroe Township, Middlesex County",47391.0,86,67,19
4489,NEW JERSEY,Montclair,40224.0,129,110,19
4490,NEW JERSEY,Montgomery Township,24233.0,37,31,6
4491,NEW JERSEY,Montvale,9021.0,27,25,2
4492,NEW JERSEY,Montville Township,21797.0,44,39,5
4493,NEW JERSEY,Moonachie,2802.0,24,21,3
4494,NEW JERSEY,Moorestown Township,20593.0,38,33,5
4495,NEW JERSEY,Morris Plains,6564.0,19,17,2
4496,NEW JERSEY,Morristown,20130.0,60,55,5
4497,NEW JERSEY,Morris Township,23286.0,55,49,6
4498,NEW JERSEY,Mountain Lakes,4377.0,14,13,1
4499,NEW JERSEY,Mountainside,7188.0,27,21,6
4500,NEW JERSEY,Mount Arlington,6161.0,16,15,1
4501,NEW JERSEY,Mount Ephraim,4759.0,14,13,1
4502,NEW JERSEY,Mount Holly Township,9522.0,28,25,3
4503,NEW JERSEY,Mount Laurel Township,41867.0,78,71,7
4504,NEW JERSEY,Mount Olive Township,30093.0,58,49,9
4505,NEW JERSEY,Mullica Township,5808.0,19,16,3
4506,NEW JERSEY,Neptune City,4573.0,20,19,1
4507,NEW JERSEY,Neptune Township,27283.0,87,75,12
4508,NEW JERSEY,Netcong,3242.0,14,13,1
4509,NEW JERSEY,Newark,295039.0,1337,1032,305
4510,NEW JERSEY,New Brunswick,58691.0,164,146,18
4511,NEW JERSEY,New Hanover Township,8121.0,3,3,0
4512,NEW JERSEY,New Milford,17005.0,44,41,3
4513,NEW JERSEY,New Providence,14785.0,27,25,2
4514,NEW JERSEY,Newton,7963.0,27,22,5
4515,NEW JERSEY,North Arlington,16288.0,39,31,8
4516,NEW JERSEY,North Bergen Township,62275.0,141,123,18
4517,NEW JERSEY,North Brunswick Township,42801.0,98,81,17
4518,NEW JERSEY,North Caldwell,6973.0,21,16,5
4519,NEW JERSEY,Northfield,8002.0,24,22,2
4520,NEW JERSEY,North Haledon,8708.0,25,22,3
4521,NEW JERSEY,North Hanover Township,7450.0,11,10,1
4522,NEW JERSEY,North Plainfield,22160.0,53,45,8
4523,NEW JERSEY,Northvale,5163.0,14,14,0
4524,NEW JERSEY,North Wildwood,3710.0,36,27,9
4525,NEW JERSEY,Norwood,5996.0,17,16,1
4526,NEW JERSEY,Nutley Township,29666.0,84,72,12
4527,NEW JERSEY,Oakland,13390.0,33,27,6
4528,NEW JERSEY,Oaklyn,4102.0,13,12,1
4529,NEW JERSEY,Ocean City,10825.0,83,70,13
4530,NEW JERSEY,Ocean Gate,2154.0,12,11,1
4531,NEW JERSEY,Oceanport,5693.0,16,15,1
4532,NEW JERSEY,"Ocean Township, Monmouth County",26776.0,78,63,15
4533,NEW JERSEY,"Ocean Township, Ocean County",9659.0,34,24,10
4534,NEW JERSEY,Ogdensburg,2228.0,6,6,0
4535,NEW JERSEY,Old Bridge Township,68177.0,121,100,21
4536,NEW JERSEY,Old Tappan,6130.0,14,13,1
4537,NEW JERSEY,Oradell,8447.0,23,22,1
4538,NEW JERSEY,Orange City,31822.0,193,147,46
4539,NEW JERSEY,Palisades Park,21969.0,41,40,1
4540,NEW JERSEY,Palmyra,7111.0,14,13,1
4541,NEW JERSEY,Paramus,27132.0,125,99,26
4542,NEW JERSEY,Park Ridge,8994.0,21,20,1
4543,NEW JERSEY,Parsippany-Troy Hills Township,53272.0,129,99,30
4544,NEW JERSEY,Passaic,72223.0,247,164,83
4545,NEW JERSEY,Paterson,150757.0,476,408,68
4546,NEW JERSEY,Paulsboro,6090.0,23,21,2
4547,NEW JERSEY,Peapack-Gladstone,2713.0,9,8,1
4548,NEW JERSEY,Pemberton Borough,1315.0,6,6,0
4549,NEW JERSEY,Pemberton Township,26829.0,55,50,5
4550,NEW JERSEY,Pennington,2722.0,7,7,0
4551,NEW JERSEY,Pennsauken Township,37212.0,90,86,4
4552,NEW JERSEY,Penns Grove,4719.0,13,12,1
4553,NEW JERSEY,Pennsville Township,12336.0,24,22,2
4554,NEW JERSEY,Pequannock Township,15447.0,36,31,5
4555,NEW JERSEY,Perth Amboy,53516.0,161,127,34
4556,NEW JERSEY,Phillipsburg,14172.0,41,40,1
4557,NEW JERSEY,Pine Beach,2307.0,7,6,1
4558,NEW JERSEY,Pine Hill,10842.0,25,23,2
4559,NEW JERSEY,Piscataway Township,59699.0,97,80,17
4560,NEW JERSEY,Pitman,9095.0,22,20,2
4561,NEW JERSEY,Plainfield,52163.0,146,122,24
4562,NEW JERSEY,Plainsboro Township,23639.0,45,37,8
4563,NEW JERSEY,Pleasantville,20038.0,60,55,5
4564,NEW JERSEY,Plumsted Township,9038.0,15,14,1
4565,NEW JERSEY,Pohatcong Township,3159.0,16,15,1
4566,NEW JERSEY,Point Pleasant,19805.0,41,32,9
4567,NEW JERSEY,Point Pleasant Beach,4794.0,30,24,6
4568,NEW JERSEY,Pompton Lakes,11374.0,30,25,5
4569,NEW JERSEY,Princeton ,32436.0,60,51,9
4570,NEW JERSEY,Prospect Park,6058.0,20,19,1
4571,NEW JERSEY,Rahway,31362.0,93,81,12
4572,NEW JERSEY,Ramsey,15463.0,41,35,6
4573,NEW JERSEY,Randolph Township,26283.0,42,36,6
4574,NEW JERSEY,Raritan,8199.0,22,21,1
4575,NEW JERSEY,Raritan Township,22594.0,41,38,3
4576,NEW JERSEY,Readington Township,15839.0,26,24,2
4577,NEW JERSEY,Red Bank,11947.0,46,38,8
4578,NEW JERSEY,Ridgefield,11599.0,31,29,2
4579,NEW JERSEY,Ridgefield Park,13389.0,40,33,7
4580,NEW JERSEY,Ridgewood,25959.0,49,45,4
4581,NEW JERSEY,Ringwood,12659.0,26,21,5
4582,NEW JERSEY,Riverdale,4348.0,22,17,5
4583,NEW JERSEY,River Edge,12072.0,27,24,3
4584,NEW JERSEY,Riverside Township,7844.0,18,18,0
4585,NEW JERSEY,Riverton,2678.0,6,6,0
4586,NEW JERSEY,River Vale Township,10394.0,27,26,1
4587,NEW JERSEY,Robbinsville Township,15197.0,37,29,8
4588,NEW JERSEY,Rochelle Park Township,5775.0,26,22,4
4589,NEW JERSEY,Rockaway,6487.0,16,15,1
4590,NEW JERSEY,Rockaway Township,27360.0,62,50,12
4591,NEW JERSEY,Roseland,6066.0,22,21,1
4592,NEW JERSEY,Roselle,22667.0,67,55,12
4593,NEW JERSEY,Roselle Park,14101.0,36,34,2
4594,NEW JERSEY,Roxbury Township,23676.0,43,42,1
4595,NEW JERSEY,Rumson,6632.0,19,16,3
4596,NEW JERSEY,Runnemede,8610.0,16,15,1
4597,NEW JERSEY,Rutherford,18990.0,45,43,2
4598,NEW JERSEY,Saddle Brook Township,14154.0,36,31,5
4599,NEW JERSEY,Saddle River,3287.0,22,17,5
4600,NEW JERSEY,Salem,4673.0,18,17,1
4601,NEW JERSEY,Sayreville,45821.0,106,92,14
4602,NEW JERSEY,Scotch Plains Township,25204.0,52,49,3
4603,NEW JERSEY,Sea Bright,1323.0,21,11,10
4604,NEW JERSEY,Sea Girt,1765.0,13,12,1
4605,NEW JERSEY,Sea Isle City,2009.0,32,23,9
4606,NEW JERSEY,Seaside Heights,3174.0,28,25,3
4607,NEW JERSEY,Seaside Park,1629.0,14,13,1
4608,NEW JERSEY,Secaucus,23102.0,94,79,15
4609,NEW JERSEY,Ship Bottom,1223.0,15,13,2
4610,NEW JERSEY,Shrewsbury,4065.0,20,16,4
4611,NEW JERSEY,Somerdale,5751.0,18,17,1
4612,NEW JERSEY,Somers Point,10091.0,34,27,7
4613,NEW JERSEY,Somerville,12717.0,33,31,2
4614,NEW JERSEY,South Amboy,9536.0,33,27,6
4615,NEW JERSEY,South Bound Brook,4722.0,14,13,1
4616,NEW JERSEY,South Brunswick Township,47479.0,113,88,25
4617,NEW JERSEY,South Hackensack Township,2529.0,22,20,2
4618,NEW JERSEY,South Orange Village,17420.0,45,39,6
4619,NEW JERSEY,South Plainfield,25038.0,74,58,16
4620,NEW JERSEY,South River,16240.0,41,31,10
4621,NEW JERSEY,South Toms River,3892.0,13,12,1
4622,NEW JERSEY,Sparta Township,18503.0,47,35,12
4623,NEW JERSEY,Spotswood,8504.0,29,25,4
4624,NEW JERSEY,"Springfield Township, Burlington County",3236.0,11,10,1
4625,NEW JERSEY,"Springfield Township, Union County",18285.0,48,44,4
4626,NEW JERSEY,Spring Lake,2881.0,14,14,0
4627,NEW JERSEY,Spring Lake Heights,4478.0,15,15,0
4628,NEW JERSEY,Stafford Township,30025.0,85,55,30
4629,NEW JERSEY,Stanhope,3258.0,10,9,1
4630,NEW JERSEY,Stone Harbor,799.0,19,17,2
4631,NEW JERSEY,Stratford,7219.0,15,15,0
4632,NEW JERSEY,Summit,22766.0,52,48,4
4633,NEW JERSEY,Surf City,1262.0,11,11,0
4634,NEW JERSEY,Teaneck Township,42218.0,107,92,15
4635,NEW JERSEY,Tenafly,14883.0,40,34,6
4636,NEW JERSEY,Tewksbury Township,5723.0,13,12,1
4637,NEW JERSEY,Tinton Falls,17345.0,45,43,2
4638,NEW JERSEY,Toms River Township,100051.0,207,161,46
4639,NEW JERSEY,Totowa,11251.0,32,29,3
4640,NEW JERSEY,Trenton,86246.0,326,265,61
4641,NEW JERSEY,Tuckerton,3586.0,14,13,1
4642,NEW JERSEY,Union Beach,5209.0,21,17,4
4643,NEW JERSEY,Union City,70023.0,208,174,34
4644,NEW JERSEY,Union Township,62583.0,185,135,50
4645,NEW JERSEY,Upper Saddle River,8498.0,21,17,4
4646,NEW JERSEY,Ventnor City,9798.0,49,38,11
4647,NEW JERSEY,Vernon Township,21715.0,42,33,9
4648,NEW JERSEY,Verona,14233.0,36,30,6
4649,NEW JERSEY,Vineland,58405.0,173,147,26
4650,NEW JERSEY,Voorhees Township,30319.0,66,56,10
4651,NEW JERSEY,Waldwick,10767.0,26,21,5
4652,NEW JERSEY,Wallington,12086.0,22,22,0
4653,NEW JERSEY,Wall Township,25455.0,87,68,19
4654,NEW JERSEY,Wanaque,12281.0,30,25,5
4655,NEW JERSEY,Warren Township,16378.0,38,31,7
4656,NEW JERSEY,"Washington Township, Bergen County",9530.0,26,21,5
4657,NEW JERSEY,"Washington Township, Gloucester County",50124.0,89,82,7
4658,NEW JERSEY,"Washington Township, Morris County",18746.0,35,32,3
4659,NEW JERSEY,"Washington Township, Warren County",6340.0,29,28,1
4660,NEW JERSEY,Watchung,6280.0,35,29,6
4661,NEW JERSEY,Waterford Township,11107.0,27,26,1
4662,NEW JERSEY,Wayne Township,55249.0,149,121,28
4663,NEW JERSEY,Weehawken Township,15266.0,70,61,9
4664,NEW JERSEY,Westampton Township,8658.0,28,25,3
4665,NEW JERSEY,West Caldwell Township,11299.0,33,27,6
4666,NEW JERSEY,West Deptford Township,21835.0,46,43,3
4667,NEW JERSEY,Westfield,30361.0,71,58,13
4668,NEW JERSEY,West Long Branch,7855.0,23,22,1
4669,NEW JERSEY,West Milford Township,27350.0,51,44,7
4670,NEW JERSEY,West New York,55716.0,136,124,12
4671,NEW JERSEY,West Orange,49619.0,109,96,13
4672,NEW JERSEY,Westville,4315.0,14,13,1
4673,NEW JERSEY,West Wildwood,535.0,5,5,0
4674,NEW JERSEY,West Windsor Township,29865.0,61,49,12
4675,NEW JERSEY,Westwood,11495.0,33,27,6
4676,NEW JERSEY,Wharton,6728.0,23,21,2
4677,NEW JERSEY,Wildwood,4877.0,53,40,13
4678,NEW JERSEY,Wildwood Crest,3011.0,29,26,3
4679,NEW JERSEY,Willingboro Township,32053.0,71,61,10
4680,NEW JERSEY,Winfield Township,1559.0,9,9,0
4681,NEW JERSEY,Winslow Township,40044.0,83,77,6
4682,NEW JERSEY,Woodbridge Township,103633.0,270,208,62
4683,NEW JERSEY,Woodbury,10192.0,36,33,3
4684,NEW JERSEY,Woodbury Heights,3085.0,8,7,1
4685,NEW JERSEY,Woodcliff Lake,6094.0,20,20,0
4686,NEW JERSEY,Woodland Park,13278.0,37,32,5
4687,NEW JERSEY,Woodlynne,3022.0,7,5,2
4688,NEW JERSEY,Wood-Ridge,9867.0,26,23,3
4689,NEW JERSEY,Woodstown,3434.0,10,9,1
4690,NEW JERSEY,Woolwich Township,14168.0,32,31,1
4691,NEW JERSEY,Wyckoff Township,17589.0,27,26,1
4692,NEW MEXICO,Albuquerque,564147.0,1474,940,534
4693,NEW MEXICO,Angel Fire,1057.0,7,5,2
4694,NEW MEXICO,Anthony,9258.0,11,10,1
4695,NEW MEXICO,Artesia,12286.0,38,23,15
4696,NEW MEXICO,Aztec,6289.0,16,14,2
4697,NEW MEXICO,Bayard,2097.0,4,3,1
4698,NEW MEXICO,Belen,7481.0,21,19,2
4699,NEW MEXICO,Bosque Farms,3844.0,15,14,1
4700,NEW MEXICO,Capitan,1454.0,4,3,1
4701,NEW MEXICO,Carlsbad,30029.0,100,67,33
4702,NEW MEXICO,Carrizozo,946.0,2,1,1
4703,NEW MEXICO,Clayton,2631.0,12,6,6
4704,NEW MEXICO,Cloudcroft,707.0,4,4,0
4705,NEW MEXICO,Clovis,38073.0,64,45,19
4706,NEW MEXICO,Corrales,8734.0,17,14,3
4707,NEW MEXICO,Edgewood,6112.0,15,12,3
4708,NEW MEXICO,Espanola,9950.0,39,28,11
4709,NEW MEXICO,Eunice,3064.0,14,10,4
4710,NEW MEXICO,Farmington,43973.0,164,118,46
4711,NEW MEXICO,Gallup,21200.0,71,55,16
4712,NEW MEXICO,Hatch,1680.0,10,9,1
4713,NEW MEXICO,Hope,104.0,1,1,0
4714,NEW MEXICO,Jal,2126.0,16,7,9
4715,NEW MEXICO,Las Cruces,105805.0,243,172,71
4716,NEW MEXICO,Las Vegas,12711.0,42,29,13
4717,NEW MEXICO,Logan,967.0,4,4,0
4718,NEW MEXICO,Lordsburg,2300.0,13,10,3
4719,NEW MEXICO,Los Lunas,16405.0,43,39,4
4720,NEW MEXICO,Lovington,11521.0,25,18,7
4721,NEW MEXICO,Magdalena,862.0,2,2,0
4722,NEW MEXICO,Milan,3640.0,8,6,2
4723,NEW MEXICO,Moriarty,1829.0,11,9,2
4724,NEW MEXICO,Mountainair,864.0,4,3,1
4725,NEW MEXICO,Raton,5836.0,16,10,6
4726,NEW MEXICO,Red River,457.0,5,4,1
4727,NEW MEXICO,Roswell,47510.0,101,81,20
4728,NEW MEXICO,Ruidoso,8066.0,31,20,11
4729,NEW MEXICO,Ruidoso Downs,2616.0,11,7,4
4730,NEW MEXICO,Santa Clara,1748.0,4,2,2
4731,NEW MEXICO,Santa Fe,85404.0,174,135,39
4732,NEW MEXICO,Santa Rosa,2603.0,15,9,6
4733,NEW MEXICO,San Ysidro,205.0,2,2,0
4734,NEW MEXICO,Silver City,9308.0,35,30,5
4735,NEW MEXICO,Socorro,8248.0,14,11,3
4736,NEW MEXICO,Springer,898.0,3,3,0
4737,NEW MEXICO,Sunland Park,18920.0,27,25,2
4738,NEW MEXICO,Taos,5856.0,24,19,5
4739,NEW MEXICO,Tatum,833.0,3,2,1
4740,NEW MEXICO,Texico,1056.0,1,1,0
4741,NEW MEXICO,Truth or Consequences,5701.0,14,10,4
4742,NEW MEXICO,Tucumcari,4775.0,14,12,2
4743,NEW MEXICO,Tularosa,3058.0,11,6,5
4744,NEW YORK,Addison Town and Village,2437.0,3,3,0
4745,NEW YORK,Akron Village,2840.0,1,1,0
4746,NEW YORK,Albany,95201.0,359,283,76
4747,NEW YORK,Albion Village,5712.0,12,12,0
4748,NEW YORK,Alfred Village,3894.0,5,5,0
4749,NEW YORK,Altamont Village,1651.0,1,1,0
4750,NEW YORK,Amherst Town,121185.0,184,153,31
4751,NEW YORK,Amityville Village,9366.0,25,24,1
4752,NEW YORK,Amsterdam,17623.0,42,38,4
4753,NEW YORK,Andover Village,958.0,1,1,0
4754,NEW YORK,Arcade Village,1902.0,6,6,0
4755,NEW YORK,Ardsley Village,4510.0,19,19,0
4756,NEW YORK,Asharoken Village,635.0,3,3,0
4757,NEW YORK,Attica Village,2371.0,5,5,0
4758,NEW YORK,Auburn,25746.0,71,65,6
4759,NEW YORK,Avon Village,3286.0,5,5,0
4760,NEW YORK,Baldwinsville Village,7854.0,14,13,1
4761,NEW YORK,Ballston Spa Village,5165.0,3,3,0
4762,NEW YORK,Batavia,14210.0,32,29,3
4763,NEW YORK,Beacon,13940.0,34,31,3
4764,NEW YORK,Bedford Town,17455.0,41,36,5
4765,NEW YORK,Binghamton,43828.0,145,133,12
4766,NEW YORK,Blooming Grove Town,11694.0,20,18,2
4767,NEW YORK,Boonville Village,1963.0,1,1,0
4768,NEW YORK,Brant Town,2067.0,1,1,0
4769,NEW YORK,Brighton Town,35689.0,44,39,5
4770,NEW YORK,Brockport Village,7821.0,16,15,1
4771,NEW YORK,Bronxville Village,6402.0,23,21,2
4772,NEW YORK,Buchanan Village,2214.0,6,6,0
4773,NEW YORK,Buffalo,253809.0,895,722,173
4774,NEW YORK,Cairo Town,6398.0,2,2,0
4775,NEW YORK,Cambridge Village,1788.0,3,3,0
4776,NEW YORK,Camden Village,2133.0,2,2,0
4777,NEW YORK,Camillus Town and Village,24267.0,26,24,2
4778,NEW YORK,Canajoharie Village,2115.0,5,5,0
4779,NEW YORK,Canandaigua,10112.0,27,25,2
4780,NEW YORK,Canastota Village,4493.0,2,2,0
4781,NEW YORK,Canisteo Village,2097.0,2,2,0
4782,NEW YORK,Canton Village,6498.0,10,9,1
4783,NEW YORK,Carmel Town,34351.0,42,34,8
4784,NEW YORK,Carthage Village,3218.0,4,4,0
4785,NEW YORK,Catskill Village,3791.0,16,14,2
4786,NEW YORK,Cayuga Heights Village,3505.0,7,6,1
4787,NEW YORK,Cazenovia Village,2844.0,6,5,1
4788,NEW YORK,Central Square Village,1725.0,6,6,0
4789,NEW YORK,Centre Island Village,404.0,6,6,0
4790,NEW YORK,Cheektowaga Town,76130.0,159,124,35
4791,NEW YORK,Chester Town,8061.0,14,14,0
4792,NEW YORK,Chester Village,4068.0,13,12,1
4793,NEW YORK,Chittenango Village,4799.0,1,1,0
4794,NEW YORK,Cicero Town,28743.0,17,16,1
4795,NEW YORK,Clarkstown Town,80188.0,182,159,23
4796,NEW YORK,Clayton Village,1755.0,2,2,0
4797,NEW YORK,Clifton Springs Village,2003.0,1,1,0
4798,NEW YORK,Cobleskill Village,4305.0,11,11,0
4799,NEW YORK,Coeymans Town,7211.0,3,2,1
4800,NEW YORK,Cohoes,16625.0,33,30,3
4801,NEW YORK,Colchester Town,1944.0,2,2,0
4802,NEW YORK,Colonie Town,78364.0,149,111,38
4803,NEW YORK,Corning,10579.0,25,21,4
4804,NEW YORK,Cornwall-on-Hudson Village,2887.0,2,2,0
4805,NEW YORK,Cornwall Town,9449.0,12,10,2
4806,NEW YORK,Crawford Town,9139.0,12,11,1
4807,NEW YORK,Croton-on-Hudson Village,8011.0,21,19,2
4808,NEW YORK,Cuba Town,3031.0,5,5,0
4809,NEW YORK,Dansville Village,4301.0,5,5,0
4810,NEW YORK,Deerpark Town,7667.0,6,6,0
4811,NEW YORK,Delhi Village,2851.0,5,5,0
4812,NEW YORK,Depew Village,14892.0,37,30,7
4813,NEW YORK,Dobbs Ferry Village,10925.0,27,25,2
4814,NEW YORK,Dolgeville Village,2031.0,2,2,0
4815,NEW YORK,Dryden Village,2007.0,4,4,0
4816,NEW YORK,Dunkirk,11622.0,36,35,1
4817,NEW YORK,East Aurora-Aurora Town,13781.0,20,15,5
4818,NEW YORK,Eastchester Town,19762.0,49,47,2
4819,NEW YORK,East Fishkill Town,29547.0,37,29,8
4820,NEW YORK,East Greenbush Town,16088.0,33,24,9
4821,NEW YORK,East Hampton Town,19970.0,89,63,26
4822,NEW YORK,East Hampton Village,1144.0,31,26,5
4823,NEW YORK,Eden Town,7584.0,3,3,0
4824,NEW YORK,Ellicott Town,4945.0,13,13,0
4825,NEW YORK,Ellicottville,1564.0,4,4,0
4826,NEW YORK,Elmira,26834.0,81,71,10
4827,NEW YORK,Elmira Heights Village,3714.0,9,9,0
4828,NEW YORK,Elmira Town,5447.0,5,5,0
4829,NEW YORK,Elmsford Village,5245.0,25,22,3
4830,NEW YORK,Endicott Village,12335.0,31,29,2
4831,NEW YORK,Evans Town,15962.0,23,17,6
4832,NEW YORK,Fairport Village,5271.0,11,10,1
4833,NEW YORK,Fallsburg Town,12375.0,21,21,0
4834,NEW YORK,Floral Park Village,15725.0,45,33,12
4835,NEW YORK,Florida Village,2894.0,1,1,0
4836,NEW YORK,Fort Edward Village,3223.0,6,6,0
4837,NEW YORK,Fort Plain Village,2207.0,3,3,0
4838,NEW YORK,Frankfort Town,4708.0,4,4,0
4839,NEW YORK,Frankfort Village,2385.0,4,4,0
4840,NEW YORK,Fredonia Village,9997.0,20,16,4
4841,NEW YORK,Freeport Village,42686.0,111,99,12
4842,NEW YORK,Fulton City,10936.0,37,36,1
4843,NEW YORK,Garden City Village,22211.0,66,52,14
4844,NEW YORK,Geddes Town,9945.0,20,17,3
4845,NEW YORK,Geneseo Village,7960.0,8,8,0
4846,NEW YORK,Geneva,12584.0,31,30,1
4847,NEW YORK,Glen Cove,27007.0,56,52,4
4848,NEW YORK,Glenville Town,21656.0,25,24,1
4849,NEW YORK,Gloversville,14454.0,37,35,2
4850,NEW YORK,Goshen Town,8803.0,6,6,0
4851,NEW YORK,Goshen Village,5326.0,21,18,3
4852,NEW YORK,Gouverneur Village,3615.0,9,6,3
4853,NEW YORK,Granville Village,2404.0,4,4,0
4854,NEW YORK,Great Neck Estates Village,2877.0,16,13,3
4855,NEW YORK,Greece Town,95202.0,106,94,12
4856,NEW YORK,Greene Village,1374.0,1,1,0
4857,NEW YORK,Greenwich Village,1690.0,2,2,0
4858,NEW YORK,Greenwood Lake Village,3044.0,6,5,1
4859,NEW YORK,Groton Village,2137.0,1,1,0
4860,NEW YORK,Guilderland Town,34129.0,53,38,15
4861,NEW YORK,Hamburg Town,46555.0,66,63,3
4862,NEW YORK,Hamburg Village,9756.0,13,12,1
4863,NEW YORK,Hamilton Village,4064.0,4,4,0
4864,NEW YORK,Harriman Village,2421.0,7,7,0
4865,NEW YORK,Hastings-on-Hudson Village,7873.0,20,20,0
4866,NEW YORK,Hempstead Village,54817.0,148,119,29
4867,NEW YORK,Herkimer Village,7213.0,20,20,0
4868,NEW YORK,Homer Village,3060.0,6,5,1
4869,NEW YORK,Hornell,8181.0,22,21,1
4870,NEW YORK,Horseheads Village,6225.0,10,10,0
4871,NEW YORK,Hudson Falls Village,6957.0,12,12,0
4872,NEW YORK,Hunter Town,2612.0,3,3,0
4873,NEW YORK,Huntington Bay Village,1442.0,5,5,0
4874,NEW YORK,Hyde Park Town,20641.0,20,16,4
4875,NEW YORK,Ilion Village,7562.0,20,19,1
4876,NEW YORK,Inlet Town,298.0,2,2,0
4877,NEW YORK,Irondequoit Town,49569.0,60,52,8
4878,NEW YORK,Irvington Village,6424.0,25,23,2
4879,NEW YORK,Ithaca,31076.0,67,59,8
4880,NEW YORK,Jamestown,28649.0,66,59,7
4881,NEW YORK,Johnson City Village,13928.0,43,39,4
4882,NEW YORK,Johnstown,8045.0,26,25,1
4883,NEW YORK,Kenmore Village,14893.0,29,25,4
4884,NEW YORK,Kensington Village,1185.0,6,6,0
4885,NEW YORK,Kent Town,13105.0,24,19,5
4886,NEW YORK,Kings Point Village,5308.0,20,18,2
4887,NEW YORK,Kingston,22631.0,70,65,5
4888,NEW YORK,Kirkland Town,8317.0,2,2,0
4889,NEW YORK,Lackawanna,17582.0,51,43,8
4890,NEW YORK,Lake Placid Village,2340.0,15,12,3
4891,NEW YORK,Lake Success Village,3146.0,23,23,0
4892,NEW YORK,Lakewood-Busti,7077.0,11,10,1
4893,NEW YORK,Lancaster Town,37644.0,66,51,15
4894,NEW YORK,Larchmont Village,6132.0,22,21,1
4895,NEW YORK,Le Roy Village,4218.0,7,7,0
4896,NEW YORK,Lewisboro Town,12418.0,3,3,0
4897,NEW YORK,Liberty Village,4315.0,20,18,2
4898,NEW YORK,Little Falls,4562.0,13,12,1
4899,NEW YORK,Liverpool Village,2401.0,5,5,0
4900,NEW YORK,Lloyd Town,10665.0,13,11,2
4901,NEW YORK,Lockport,20100.0,51,48,3
4902,NEW YORK,Long Beach,33294.0,84,68,16
4903,NEW YORK,Lowville Village,3277.0,6,6,0
4904,NEW YORK,Lynbrook Village,19272.0,57,50,7
4905,NEW YORK,Macedon Town and Village,8843.0,8,7,1
4906,NEW YORK,Malone Village,5593.0,12,12,0
4907,NEW YORK,Malverne Village,8452.0,21,21,0
4908,NEW YORK,Mamaroneck Town,11807.0,38,37,1
4909,NEW YORK,Mamaroneck Village,19090.0,58,50,8
4910,NEW YORK,Manlius Town,24096.0,40,36,4
4911,NEW YORK,Marlborough Town,8572.0,10,8,2
4912,NEW YORK,Massena Village,10045.0,24,19,5
4913,NEW YORK,Mechanicville,4987.0,9,9,0
4914,NEW YORK,Medina Village,5539.0,13,12,1
4915,NEW YORK,Menands Village,3817.0,16,13,3
4916,NEW YORK,Middleport Village,1719.0,3,3,0
4917,NEW YORK,Middletown,28010.0,77,64,13
4918,NEW YORK,Mohawk Village,2487.0,4,4,0
4919,NEW YORK,Monroe Village,8577.0,22,17,5
4920,NEW YORK,Montgomery Town,9153.0,16,13,3
4921,NEW YORK,Montgomery Village,4557.0,4,4,0
4922,NEW YORK,Monticello Village,6361.0,22,20,2
4923,NEW YORK,Mount Hope Town,6513.0,6,6,0
4924,NEW YORK,Mount Pleasant Town,26564.0,54,48,6
4925,NEW YORK,Mount Vernon,66713.0,212,151,61
4926,NEW YORK,Newark Village,8696.0,15,14,1
4927,NEW YORK,New Berlin Town,1500.0,1,1,0
4928,NEW YORK,Newburgh,27801.0,75,63,12
4929,NEW YORK,Newburgh Town,31705.0,60,48,12
4930,NEW YORK,New Castle Town,17622.0,38,36,2
4931,NEW YORK,New Hartford Town and Village,20124.0,23,20,3
4932,NEW YORK,New Paltz Town and Village,14109.0,23,20,3
4933,NEW YORK,New Rochelle,81367.0,197,167,30
4934,NEW YORK,New Windsor Town,27702.0,58,47,11
4935,NEW YORK,New York,8475387.0,50029,35047,14982
4936,NEW YORK,New York Mills Village,3172.0,3,3,0
4937,NEW YORK,Niagara Falls,47139.0,164,146,18
4938,NEW YORK,Niagara Town,7949.0,8,7,1
4939,NEW YORK,Niskayuna Town,22383.0,28,27,1
4940,NEW YORK,North Greenbush Town,12306.0,20,18,2
4941,NEW YORK,Northport Village,7245.0,22,17,5
4942,NEW YORK,North Syracuse Village,6572.0,12,11,1
4943,NEW YORK,Norwich,6370.0,21,20,1
4944,NEW YORK,Ogdensburg,10319.0,22,19,3
4945,NEW YORK,Ogden Town,20715.0,15,12,3
4946,NEW YORK,Old Brookville Village,2181.0,30,24,6
4947,NEW YORK,Old Westbury Village,4052.0,30,25,5
4948,NEW YORK,Olean,13272.0,37,31,6
4949,NEW YORK,Oneida,10776.0,29,25,4
4950,NEW YORK,Oneonta City,13671.0,29,23,6
4951,NEW YORK,Orangetown Town,37135.0,88,80,8
4952,NEW YORK,Orchard Park Town,29778.0,48,36,12
4953,NEW YORK,Ossining Village,24607.0,63,57,6
4954,NEW YORK,Oswego City,17132.0,50,44,6
4955,NEW YORK,Owego Village,3816.0,4,3,1
4956,NEW YORK,Oxford Village,1362.0,2,2,0
4957,NEW YORK,Oyster Bay Cove Village,4279.0,14,14,0
4958,NEW YORK,Peekskill,24136.0,58,49,9
4959,NEW YORK,Pelham Manor Village,5461.0,26,25,1
4960,NEW YORK,Pelham Village,6920.0,27,24,3
4961,NEW YORK,Penn Yan Village,4928.0,14,13,1
4962,NEW YORK,Perry Village,3439.0,5,5,0
4963,NEW YORK,Piermont Village,2528.0,8,8,0
4964,NEW YORK,Plattsburgh City,19144.0,53,47,6
4965,NEW YORK,Pleasantville Village,7239.0,26,23,3
4966,NEW YORK,Port Chester Village,28847.0,59,58,1
4967,NEW YORK,Port Dickinson Village,1497.0,5,4,1
4968,NEW YORK,Port Jervis,8415.0,31,30,1
4969,NEW YORK,Portville Village,934.0,1,1,0
4970,NEW YORK,Port Washington,19301.0,70,62,8
4971,NEW YORK,Poughkeepsie,30409.0,112,85,27
4972,NEW YORK,Poughkeepsie Town,38808.0,95,81,14
4973,NEW YORK,Pound Ridge Town,5066.0,2,1,1
4974,NEW YORK,Pulaski Village,2198.0,1,1,0
4975,NEW YORK,Quogue Village,1019.0,14,13,1
4976,NEW YORK,Ramapo Town,96160.0,118,101,17
4977,NEW YORK,Red Hook Village,1933.0,4,4,0
4978,NEW YORK,Rensselaer City,9119.0,31,25,6
4979,NEW YORK,Riverhead Town,33424.0,106,90,16
4980,NEW YORK,Rochester,204735.0,756,668,88
4981,NEW YORK,Rockville Centre Village,24431.0,65,56,9
4982,NEW YORK,Rome,31991.0,80,78,2
4983,NEW YORK,Rosendale Town,5730.0,2,2,0
4984,NEW YORK,Rotterdam Town,30179.0,42,40,2
4985,NEW YORK,Rye,15625.0,39,34,5
4986,NEW YORK,Rye Brook Village,9592.0,27,26,1
4987,NEW YORK,Sag Harbor Village,2305.0,12,12,0
4988,NEW YORK,Salamanca,5337.0,18,18,0
4989,NEW YORK,Sands Point Village,2814.0,20,20,0
4990,NEW YORK,Saranac Lake Village,5171.0,11,11,0
4991,NEW YORK,Saratoga Springs,28461.0,88,72,16
4992,NEW YORK,Saugerties Town,18954.0,28,24,4
4993,NEW YORK,Scarsdale Village,17847.0,46,40,6
4994,NEW YORK,Schenectady,65140.0,171,147,24
4995,NEW YORK,Schodack Town,11594.0,11,10,1
4996,NEW YORK,Scotia Village,7605.0,14,13,1
4997,NEW YORK,Seneca Falls Town,8570.0,19,17,2
4998,NEW YORK,Shandaken Town,2912.0,4,4,0
4999,NEW YORK,Shawangunk Town,13751.0,6,6,0
5000,NEW YORK,Shelter Island Town,2421.0,13,12,1
5001,NEW YORK,Sherrill,2947.0,3,3,0
5002,NEW YORK,Sidney Village,3525.0,8,8,0
5003,NEW YORK,Skaneateles Village,2466.0,5,4,1
5004,NEW YORK,Sleepy Hollow Village,10073.0,24,24,0
5005,NEW YORK,Solvay Village,6219.0,15,14,1
5006,NEW YORK,Southampton Town,51289.0,137,99,38
5007,NEW YORK,Southampton Village,3334.0,45,31,14
5008,NEW YORK,South Glens Falls Village,3627.0,6,6,0
5009,NEW YORK,South Nyack Village,3284.0,3,3,0
5010,NEW YORK,Southold Town,20045.0,71,55,16
5011,NEW YORK,Spring Valley Village,32340.0,65,57,8
5012,NEW YORK,Stony Point Town,15309.0,25,24,1
5013,NEW YORK,Syracuse,140847.0,443,376,67
5014,NEW YORK,Tarrytown Village,11287.0,38,34,4
5015,NEW YORK,Ticonderoga Town,4698.0,7,7,0
5016,NEW YORK,Tonawanda,14715.0,34,28,6
5017,NEW YORK,Tonawanda Town,56178.0,142,98,44
5018,NEW YORK,Troy,48678.0,143,134,9
5019,NEW YORK,Trumansburg Village,1658.0,1,1,0
5020,NEW YORK,Tuckahoe Village,6481.0,24,21,3
5021,NEW YORK,Tupper Lake Village,3409.0,12,12,0
5022,NEW YORK,Tuxedo Park Village,591.0,4,3,1
5023,NEW YORK,Ulster Town,12745.0,28,24,4
5024,NEW YORK,Utica,58965.0,178,163,15
5025,NEW YORK,Vestal Town,28843.0,43,39,4
5026,NEW YORK,Walden Village,6593.0,15,12,3
5027,NEW YORK,Wallkill Town,29523.0,51,49,2
5028,NEW YORK,Walton Village,2747.0,5,5,0
5029,NEW YORK,Warsaw Village,3141.0,5,5,0
5030,NEW YORK,Warwick Town,18357.0,36,31,5
5031,NEW YORK,Washingtonville Village,5713.0,15,13,2
5032,NEW YORK,Waterford Town and Village,8420.0,10,8,2
5033,NEW YORK,Waterloo Village,4837.0,9,8,1
5034,NEW YORK,Watertown,24091.0,71,68,3
5035,NEW YORK,Watervliet,9766.0,25,25,0
5036,NEW YORK,Waverly Village,4081.0,11,10,1
5037,NEW YORK,Webb Town,1773.0,8,7,1
5038,NEW YORK,Webster Town and Village,45651.0,36,32,4
5039,NEW YORK,Weedsport Village,1671.0,1,1,0
5040,NEW YORK,Wellsville Village,4296.0,12,11,1
5041,NEW YORK,Westfield Village,2938.0,7,7,0
5042,NEW YORK,Westhampton Beach Village,1817.0,16,14,2
5043,NEW YORK,West Seneca Town,45155.0,79,66,13
5044,NEW YORK,Whitehall Village,2507.0,3,3,0
5045,NEW YORK,White Plains,58426.0,198,187,11
5046,NEW YORK,Whitesboro Village,3564.0,5,5,0
5047,NEW YORK,Whitestown Town,8816.0,5,5,0
5048,NEW YORK,Windham Town,1682.0,2,2,0
5049,NEW YORK,Woodbury Town,11094.0,21,17,4
5050,NEW YORK,Woodstock Town,5743.0,10,10,0
5051,NEW YORK,Yonkers,200397.0,694,613,81
5052,NEW YORK,Yorktown Town,35970.0,63,54,9
5053,NORTH CAROLINA,Aberdeen,8576.0,30,28,2
5054,NORTH CAROLINA,Ahoskie,4653.0,19,17,2
5055,NORTH CAROLINA,Albemarle,16391.0,51,38,13
5056,NORTH CAROLINA,Andrews,1863.0,5,4,1
5057,NORTH CAROLINA,Angier,5610.0,15,15,0
5058,NORTH CAROLINA,Apex,67878.0,111,93,18
5059,NORTH CAROLINA,Archdale,11572.0,33,28,5
5060,NORTH CAROLINA,Asheboro,26082.0,91,78,13
5061,NORTH CAROLINA,Asheville,93855.0,211,162,49
5062,NORTH CAROLINA,Atlantic Beach,1516.0,17,16,1
5063,NORTH CAROLINA,Ayden,5174.0,20,16,4
5064,NORTH CAROLINA,Badin,1930.0,4,4,0
5065,NORTH CAROLINA,Bailey,569.0,1,1,0
5066,NORTH CAROLINA,Bakersville,439.0,1,1,0
5067,NORTH CAROLINA,Bald Head Island,189.0,26,25,1
5068,NORTH CAROLINA,Banner Elk,1088.0,9,8,1
5069,NORTH CAROLINA,Beaufort,4522.0,19,18,1
5070,NORTH CAROLINA,Beech Mountain,320.0,14,10,4
5071,NORTH CAROLINA,Belhaven,1572.0,7,6,1
5072,NORTH CAROLINA,Belmont,12891.0,46,40,6
5073,NORTH CAROLINA,Benson,4101.0,16,15,1
5074,NORTH CAROLINA,Bessemer City,5677.0,13,13,0
5075,NORTH CAROLINA,Bethel,1617.0,3,3,0
5076,NORTH CAROLINA,Beulaville,1295.0,6,6,0
5077,NORTH CAROLINA,Biltmore Forest,1440.0,16,12,4
5078,NORTH CAROLINA,Biscoe,1704.0,10,9,1
5079,NORTH CAROLINA,Black Creek,768.0,1,1,0
5080,NORTH CAROLINA,Black Mountain,8297.0,23,22,1
5081,NORTH CAROLINA,Bladenboro,1684.0,6,6,0
5082,NORTH CAROLINA,Blowing Rock,1324.0,15,13,2
5083,NORTH CAROLINA,Boiling Spring Lakes,6545.0,14,12,2
5084,NORTH CAROLINA,Boiling Springs,4614.0,11,10,1
5085,NORTH CAROLINA,Boone,20321.0,38,30,8
5086,NORTH CAROLINA,Boonville,1105.0,5,5,0
5087,NORTH CAROLINA,Brevard,7922.0,27,24,3
5088,NORTH CAROLINA,Bridgeton,441.0,1,1,0
5089,NORTH CAROLINA,Broadway,1304.0,4,4,0
5090,NORTH CAROLINA,Bryson City,1445.0,8,7,1
5091,NORTH CAROLINA,Bunn,407.0,3,2,1
5092,NORTH CAROLINA,Burgaw,4154.0,15,15,0
5093,NORTH CAROLINA,Burlington,56065.0,171,123,48
5094,NORTH CAROLINA,Burnsville,1638.0,8,8,0
5095,NORTH CAROLINA,Butner,7902.0,38,32,6
5096,NORTH CAROLINA,Canton,4387.0,18,13,5
5097,NORTH CAROLINA,Cape Carteret,2068.0,7,7,0
5098,NORTH CAROLINA,Carolina Beach,6437.0,27,25,2
5099,NORTH CAROLINA,Carrboro,21413.0,34,31,3
5100,NORTH CAROLINA,Carthage,2626.0,11,10,1
5101,NORTH CAROLINA,Cary,177735.0,216,171,45
5102,NORTH CAROLINA,Caswell Beach,442.0,4,4,0
5103,NORTH CAROLINA,Chadbourn,1686.0,8,7,1
5104,NORTH CAROLINA,Chapel Hill,64388.0,105,86,19
5105,NORTH CAROLINA,Charlotte-Mecklenburg1,956282.0,2281,1734,547
5106,NORTH CAROLINA,Cherryville,6180.0,19,14,5
5107,NORTH CAROLINA,China Grove,4256.0,12,12,0
5108,NORTH CAROLINA,Chocowinity,771.0,3,3,0
5109,NORTH CAROLINA,Claremont,1420.0,8,8,0
5110,NORTH CAROLINA,Clayton,27775.0,55,52,3
5111,NORTH CAROLINA,Cleveland,877.0,5,5,0
5112,NORTH CAROLINA,Clinton,8299.0,29,24,5
5113,NORTH CAROLINA,Coats,2563.0,7,7,0
5114,NORTH CAROLINA,Columbus,1008.0,9,8,1
5115,NORTH CAROLINA,Concord,100631.0,214,185,29
5116,NORTH CAROLINA,Conover,8601.0,29,26,3
5117,NORTH CAROLINA,Conway,711.0,2,2,0
5118,NORTH CAROLINA,Cooleemee,983.0,1,1,0
5119,NORTH CAROLINA,Cornelius,31453.0,73,57,16
5120,NORTH CAROLINA,Cramerton,4546.0,16,16,0
5121,NORTH CAROLINA,Creedmoor,4670.0,20,16,4
5122,NORTH CAROLINA,Dallas,4891.0,17,15,2
5123,NORTH CAROLINA,Davidson,13457.0,27,25,2
5124,NORTH CAROLINA,Dobson,1529.0,8,8,0
5125,NORTH CAROLINA,Drexel,1859.0,5,5,0
5126,NORTH CAROLINA,Duck,396.0,12,12,0
5127,NORTH CAROLINA,Dunn,9721.0,47,42,5
5128,NORTH CAROLINA,Durham,291962.0,634,460,174
5129,NORTH CAROLINA,East Bend,593.0,2,2,0
5130,NORTH CAROLINA,East Spencer,1557.0,7,7,0
5131,NORTH CAROLINA,Eden,14786.0,49,45,4
5132,NORTH CAROLINA,Edenton,4528.0,16,14,2
5133,NORTH CAROLINA,Elizabeth City,17948.0,67,60,7
5134,NORTH CAROLINA,Elizabethtown,3353.0,15,14,1
5135,NORTH CAROLINA,Elkin,3998.0,21,17,4
5136,NORTH CAROLINA,Elon,12521.0,21,20,1
5137,NORTH CAROLINA,Emerald Isle,3677.0,20,18,2
5138,NORTH CAROLINA,Enfield,2234.0,8,7,1
5139,NORTH CAROLINA,Erwin,5270.0,12,11,1
5140,NORTH CAROLINA,Fair Bluff,872.0,3,3,0
5141,NORTH CAROLINA,Fairmont,2568.0,9,9,0
5142,NORTH CAROLINA,Farmville,4756.0,22,18,4
5143,NORTH CAROLINA,Fayetteville,212047.0,521,348,173
5144,NORTH CAROLINA,Fletcher,8573.0,17,16,1
5145,NORTH CAROLINA,Forest City,7106.0,35,33,2
5146,NORTH CAROLINA,Four Oaks,2436.0,8,8,0
5147,NORTH CAROLINA,Foxfire Village,1076.0,4,4,0
5148,NORTH CAROLINA,Franklin,4145.0,18,17,1
5149,NORTH CAROLINA,Franklinton,2344.0,10,9,1
5150,NORTH CAROLINA,Fremont,1263.0,4,4,0
5151,NORTH CAROLINA,Fuquay-Varina,34018.0,58,51,7
5152,NORTH CAROLINA,Garner,32889.0,82,70,12
5153,NORTH CAROLINA,Garysburg,900.0,2,2,0
5154,NORTH CAROLINA,Gaston,1010.0,2,2,0
5155,NORTH CAROLINA,Gastonia,78260.0,185,163,22
5156,NORTH CAROLINA,Gibsonville,7492.0,22,21,1
5157,NORTH CAROLINA,Glen Alpine,1486.0,4,4,0
5158,NORTH CAROLINA,Goldsboro,34352.0,92,80,12
5159,NORTH CAROLINA,Graham,15919.0,42,38,4
5160,NORTH CAROLINA,Granite Falls,4652.0,15,13,2
5161,NORTH CAROLINA,Granite Quarry,3008.0,9,9,0
5162,NORTH CAROLINA,Greensboro,300865.0,774,671,103
5163,NORTH CAROLINA,Greenville,95815.0,223,178,45
5164,NORTH CAROLINA,Grifton,2717.0,6,6,0
5165,NORTH CAROLINA,Havelock,19450.0,36,26,10
5166,NORTH CAROLINA,Haw River,2558.0,9,9,0
5167,NORTH CAROLINA,Henderson,15067.0,49,41,8
5168,NORTH CAROLINA,Hendersonville,14351.0,55,43,12
5169,NORTH CAROLINA,Hickory,41604.0,143,110,33
5170,NORTH CAROLINA,Highlands,989.0,14,13,1
5171,NORTH CAROLINA,High Point,114492.0,274,231,43
5172,NORTH CAROLINA,Hillsborough,7291.0,32,28,4
5173,NORTH CAROLINA,Holden Beach,686.0,10,9,1
5174,NORTH CAROLINA,Holly Ridge,3365.0,13,12,1
5175,NORTH CAROLINA,Holly Springs,41798.0,86,68,18
5176,NORTH CAROLINA,Hope Mills,15914.0,41,33,8
5177,NORTH CAROLINA,Hot Springs,576.0,1,1,0
5178,NORTH CAROLINA,Hudson,3696.0,14,13,1
5179,NORTH CAROLINA,Huntersville,60450.0,102,86,16
5180,NORTH CAROLINA,Indian Beach,119.0,5,5,0
5181,NORTH CAROLINA,Jacksonville,76130.0,152,119,33
5182,NORTH CAROLINA,Jefferson,1528.0,6,6,0
5183,NORTH CAROLINA,Jonesville,2198.0,10,9,1
5184,NORTH CAROLINA,Kannapolis,53044.0,105,76,29
5185,NORTH CAROLINA,Kenansville,849.0,3,3,0
5186,NORTH CAROLINA,Kenly,1655.0,8,8,0
5187,NORTH CAROLINA,Kernersville,25074.0,84,65,19
5188,NORTH CAROLINA,Kill Devil Hills,7488.0,33,27,6
5189,NORTH CAROLINA,King,6916.0,27,24,3
5190,NORTH CAROLINA,Kings Mountain,11162.0,41,33,8
5191,NORTH CAROLINA,Kinston,19672.0,68,61,7
5192,NORTH CAROLINA,Kitty Hawk,3632.0,16,15,1
5193,NORTH CAROLINA,Knightdale,18970.0,35,32,3
5194,NORTH CAROLINA,Kure Beach,2083.0,14,13,1
5195,NORTH CAROLINA,Lake Lure,1152.0,9,8,1
5196,NORTH CAROLINA,Lake Royale,2529.0,8,8,0
5197,NORTH CAROLINA,Lake Waccamaw,1385.0,4,4,0
5198,NORTH CAROLINA,Landis,3155.0,11,11,0
5199,NORTH CAROLINA,Laurel Park,2358.0,7,7,0
5200,NORTH CAROLINA,Laurinburg,14798.0,39,37,2
5201,NORTH CAROLINA,Leland,27271.0,42,39,3
5202,NORTH CAROLINA,Lenoir,17881.0,69,52,17
5203,NORTH CAROLINA,Lexington,19162.0,66,53,13
5204,NORTH CAROLINA,Liberty,2672.0,11,10,1
5205,NORTH CAROLINA,Lilesville,478.0,1,1,0
5206,NORTH CAROLINA,Lillington,3680.0,13,12,1
5207,NORTH CAROLINA,Lincolnton,11641.0,34,31,3
5208,NORTH CAROLINA,Littleton,578.0,3,3,0
5209,NORTH CAROLINA,Locust,3307.0,15,15,0
5210,NORTH CAROLINA,Long View,4959.0,17,17,0
5211,NORTH CAROLINA,Louisburg,3722.0,17,16,1
5212,NORTH CAROLINA,Lowell,3767.0,10,10,0
5213,NORTH CAROLINA,Lumberton,20109.0,95,86,9
5214,NORTH CAROLINA,Madison,2095.0,17,17,0
5215,NORTH CAROLINA,Maggie Valley,1268.0,10,9,1
5216,NORTH CAROLINA,Magnolia,951.0,1,1,0
5217,NORTH CAROLINA,Maiden,3430.0,19,18,1
5218,NORTH CAROLINA,Manteo,1483.0,8,7,1
5219,NORTH CAROLINA,Marion,7916.0,28,26,2
5220,NORTH CAROLINA,Marshall,920.0,4,4,0
5221,NORTH CAROLINA,Mars Hill,1884.0,5,5,0
5222,NORTH CAROLINA,Marshville,2875.0,9,9,0
5223,NORTH CAROLINA,Matthews,34438.0,80,64,16
5224,NORTH CAROLINA,Maxton,2321.0,13,9,4
5225,NORTH CAROLINA,Mayodan,2401.0,15,15,0
5226,NORTH CAROLINA,Maysville,908.0,3,3,0
5227,NORTH CAROLINA,Mebane,17365.0,38,34,4
5228,NORTH CAROLINA,Micro,565.0,2,2,0
5229,NORTH CAROLINA,Middlesex,835.0,5,5,0
5230,NORTH CAROLINA,Mint Hill,28701.0,39,36,3
5231,NORTH CAROLINA,Misenheimer,744.0,5,5,0
5232,NORTH CAROLINA,Monroe,35948.0,100,90,10
5233,NORTH CAROLINA,Montreat,965.0,4,4,0
5234,NORTH CAROLINA,Mooresville,40560.0,108,85,23
5235,NORTH CAROLINA,Morehead City,9774.0,44,41,3
5236,NORTH CAROLINA,Morganton,16605.0,90,56,34
5237,NORTH CAROLINA,Morrisville,32018.0,41,39,2
5238,NORTH CAROLINA,Mount Airy,10152.0,44,36,8
5239,NORTH CAROLINA,Mount Gilead,1137.0,8,8,0
5240,NORTH CAROLINA,Mount Holly,16720.0,41,33,8
5241,NORTH CAROLINA,Mount Olive,4665.0,17,16,1
5242,NORTH CAROLINA,Murfreesboro,2873.0,9,8,1
5243,NORTH CAROLINA,Murphy,1672.0,12,10,2
5244,NORTH CAROLINA,Nags Head,3021.0,24,22,2
5245,NORTH CAROLINA,Nashville,5572.0,18,17,1
5246,NORTH CAROLINA,Navassa,2675.0,1,1,0
5247,NORTH CAROLINA,New Bern,29985.0,110,85,25
5248,NORTH CAROLINA,Newland,693.0,5,5,0
5249,NORTH CAROLINA,Newport,4691.0,9,9,0
5250,NORTH CAROLINA,Newton,13253.0,37,28,9
5251,NORTH CAROLINA,Newton Grove,562.0,2,2,0
5252,NORTH CAROLINA,Norlina,1032.0,3,3,0
5253,NORTH CAROLINA,North Topsail Beach,743.0,15,13,2
5254,NORTH CAROLINA,Northwest,813.0,1,1,0
5255,NORTH CAROLINA,North Wilkesboro,4069.0,21,20,1
5256,NORTH CAROLINA,Norwood,2479.0,10,10,0
5257,NORTH CAROLINA,Oakboro,1935.0,8,8,0
5258,NORTH CAROLINA,Oak Island,8955.0,22,20,2
5259,NORTH CAROLINA,Ocean Isle Beach,726.0,13,12,1
5260,NORTH CAROLINA,Old Fort,926.0,3,3,0
5261,NORTH CAROLINA,Oriental,856.0,2,2,0
5262,NORTH CAROLINA,Oxford,8950.0,29,25,4
5263,NORTH CAROLINA,Parkton,428.0,2,2,0
5264,NORTH CAROLINA,Pembroke,2929.0,14,11,3
5265,NORTH CAROLINA,Pikeville,677.0,2,2,0
5266,NORTH CAROLINA,Pilot Mountain,1402.0,9,8,1
5267,NORTH CAROLINA,Pinebluff,1686.0,3,3,0
5268,NORTH CAROLINA,Pinehurst,17253.0,28,23,5
5269,NORTH CAROLINA,Pine Knoll Shores,1313.0,9,9,0
5270,NORTH CAROLINA,Pine Level,2123.0,5,5,0
5271,NORTH CAROLINA,Pinetops,1207.0,9,7,2
5272,NORTH CAROLINA,Pineville,9371.0,43,39,4
5273,NORTH CAROLINA,Pink Hill,507.0,2,2,0
5274,NORTH CAROLINA,Pittsboro,4491.0,11,11,0
5275,NORTH CAROLINA,Plymouth,3285.0,6,5,1
5276,NORTH CAROLINA,Polkton,2236.0,1,1,0
5277,NORTH CAROLINA,Princeton,1451.0,4,4,0
5278,NORTH CAROLINA,Raeford,4987.0,19,17,2
5279,NORTH CAROLINA,Raleigh,481823.0,744,648,96
5280,NORTH CAROLINA,Ramseur,1689.0,6,6,0
5281,NORTH CAROLINA,Randleman,4138.0,16,16,0
5282,NORTH CAROLINA,Ranlo,3736.0,13,12,1
5283,NORTH CAROLINA,Red Springs,3218.0,15,14,1
5284,NORTH CAROLINA,Reidsville,13948.0,55,47,8
5285,NORTH CAROLINA,Richlands,1741.0,8,8,0
5286,NORTH CAROLINA,Rich Square,822.0,3,1,2
5287,NORTH CAROLINA,River Bend,2995.0,6,6,0
5288,NORTH CAROLINA,Roanoke Rapids,14046.0,38,34,4
5289,NORTH CAROLINA,Robbins,1254.0,4,4,0
5290,NORTH CAROLINA,Robersonville,1307.0,3,3,0
5291,NORTH CAROLINA,Rockingham,8424.0,38,36,2
5292,NORTH CAROLINA,Rockwell,2170.0,7,7,0
5293,NORTH CAROLINA,Rocky Mount,53305.0,163,131,32
5294,NORTH CAROLINA,Rolesville,9679.0,22,21,1
5295,NORTH CAROLINA,Rose Hill,1620.0,5,5,0
5296,NORTH CAROLINA,Rowland,980.0,5,4,1
5297,NORTH CAROLINA,Roxboro,8387.0,34,29,5
5298,NORTH CAROLINA,Rutherfordton,4081.0,15,15,0
5299,NORTH CAROLINA,Salisbury,33856.0,81,70,11
5300,NORTH CAROLINA,Saluda,702.0,3,3,0
5301,NORTH CAROLINA,Sanford,30583.0,92,69,23
5302,NORTH CAROLINA,Scotland Neck,1789.0,8,7,1
5303,NORTH CAROLINA,Seagrove,231.0,1,1,0
5304,NORTH CAROLINA,Selma,7454.0,18,17,1
5305,NORTH CAROLINA,Seven Devils,204.0,6,6,0
5306,NORTH CAROLINA,Shallotte,4511.0,18,17,1
5307,NORTH CAROLINA,Sharpsburg,2017.0,9,8,1
5308,NORTH CAROLINA,Shelby,20128.0,84,72,12
5309,NORTH CAROLINA,Siler City,8473.0,23,17,6
5310,NORTH CAROLINA,Smithfield,13581.0,42,38,4
5311,NORTH CAROLINA,Snow Hill,1476.0,6,6,0
5312,NORTH CAROLINA,Southern Pines,15358.0,48,39,9
5313,NORTH CAROLINA,Southern Shores,3026.0,11,10,1
5314,NORTH CAROLINA,Southport,4226.0,12,12,0
5315,NORTH CAROLINA,Sparta,1721.0,6,6,0
5316,NORTH CAROLINA,Spencer,3260.0,9,8,1
5317,NORTH CAROLINA,Spring Hope,1319.0,7,7,0
5318,NORTH CAROLINA,Spring Lake,12028.0,25,23,2
5319,NORTH CAROLINA,Spruce Pine,2115.0,11,11,0
5320,NORTH CAROLINA,Stallings,16746.0,23,21,2
5321,NORTH CAROLINA,Stanfield,1559.0,5,5,0
5322,NORTH CAROLINA,Stanley,3821.0,13,12,1
5323,NORTH CAROLINA,Stantonsburg,780.0,3,3,0
5324,NORTH CAROLINA,Star,846.0,4,4,0
5325,NORTH CAROLINA,Statesville,28420.0,98,75,23
5326,NORTH CAROLINA,Stoneville,1257.0,5,5,0
5327,NORTH CAROLINA,St. Pauls,2279.0,17,12,5
5328,NORTH CAROLINA,Sugar Mountain,197.0,5,5,0
5329,NORTH CAROLINA,Sunset Beach,4236.0,17,17,0
5330,NORTH CAROLINA,Surf City,2602.0,23,22,1
5331,NORTH CAROLINA,Swansboro,3472.0,14,13,1
5332,NORTH CAROLINA,Sylva,2757.0,12,12,0
5333,NORTH CAROLINA,Tabor City,3883.0,11,10,1
5334,NORTH CAROLINA,Tarboro,10484.0,33,27,6
5335,NORTH CAROLINA,Taylorsville,2145.0,13,13,0
5336,NORTH CAROLINA,Taylortown,891.0,3,3,0
5337,NORTH CAROLINA,Thomasville,26704.0,70,64,6
5338,NORTH CAROLINA,Topsail Beach,446.0,8,7,1
5339,NORTH CAROLINA,Trent Woods,3973.0,6,6,0
5340,NORTH CAROLINA,Troutman,2856.0,15,14,1
5341,NORTH CAROLINA,Troy,3274.0,10,9,1
5342,NORTH CAROLINA,Tryon,1635.0,9,7,2
5343,NORTH CAROLINA,Valdese,4402.0,14,13,1
5344,NORTH CAROLINA,Vanceboro,950.0,4,4,0
5345,NORTH CAROLINA,Vass,811.0,4,3,1
5346,NORTH CAROLINA,Wadesboro,5190.0,24,19,5
5347,NORTH CAROLINA,Wagram,766.0,1,1,0
5348,NORTH CAROLINA,Wake Forest,49457.0,99,83,16
5349,NORTH CAROLINA,Wallace,3855.0,20,16,4
5350,NORTH CAROLINA,Walnut Creek,865.0,4,3,1
5351,NORTH CAROLINA,Warrenton,814.0,6,5,1
5352,NORTH CAROLINA,Warsaw,3081.0,14,10,4
5353,NORTH CAROLINA,Washington,9451.0,37,28,9
5354,NORTH CAROLINA,Waxhaw,19089.0,32,30,2
5355,NORTH CAROLINA,Waynesville,10632.0,43,32,11
5356,NORTH CAROLINA,Weaverville,4077.0,17,16,1
5357,NORTH CAROLINA,Weldon,1438.0,8,8,0
5358,NORTH CAROLINA,Wendell,9841.0,21,19,2
5359,NORTH CAROLINA,West Jefferson,1311.0,9,9,0
5360,NORTH CAROLINA,Whispering Pines,3515.0,9,8,1
5361,NORTH CAROLINA,Whitakers,696.0,3,3,0
5362,NORTH CAROLINA,White Lake,738.0,5,5,0
5363,NORTH CAROLINA,Whiteville,5231.0,21,17,4
5364,NORTH CAROLINA,Wilkesboro,3419.0,22,20,2
5365,NORTH CAROLINA,Williamston,5072.0,23,21,2
5366,NORTH CAROLINA,Wilmington,126759.0,321,243,78
5367,NORTH CAROLINA,Wilson,49507.0,123,108,15
5368,NORTH CAROLINA,Wilson's Mills,2911.0,8,8,0
5369,NORTH CAROLINA,Windsor,3485.0,9,9,0
5370,NORTH CAROLINA,Winfall,621.0,1,1,0
5371,NORTH CAROLINA,Wingate,4873.0,8,7,1
5372,NORTH CAROLINA,Winston-Salem,249998.0,626,456,170
5373,NORTH CAROLINA,Winterville,10225.0,21,20,1
5374,NORTH CAROLINA,Woodfin,6718.0,18,17,1
5375,NORTH CAROLINA,Woodland,691.0,1,1,0
5376,NORTH CAROLINA,Wrightsville Beach,2519.0,27,25,2
5377,NORTH CAROLINA,Yadkinville,2864.0,12,11,1
5378,NORTH CAROLINA,Youngsville,1442.0,13,11,2
5379,NORTH CAROLINA,Zebulon,6764.0,22,21,1
5380,NORTH DAKOTA,Berthold,494.0,1,1,0
5381,NORTH DAKOTA,Beulah,3129.0,7,6,1
5382,NORTH DAKOTA,Bismarck,75396.0,156,126,30
5383,NORTH DAKOTA,Bowman,1571.0,4,4,0
5384,NORTH DAKOTA,Burlington,1213.0,3,3,0
5385,NORTH DAKOTA,Carrington,1940.0,5,5,0
5386,NORTH DAKOTA,Cavalier,1190.0,3,3,0
5387,NORTH DAKOTA,Devils Lake,7237.0,21,19,2
5388,NORTH DAKOTA,Dickinson,24179.0,64,42,22
5389,NORTH DAKOTA,Dunseith,767.0,3,3,0
5390,NORTH DAKOTA,Ellendale,1160.0,2,2,0
5391,NORTH DAKOTA,Emerado,464.0,1,1,0
5392,NORTH DAKOTA,Fargo,127313.0,199,180,19
5393,NORTH DAKOTA,Garrison,1458.0,3,3,0
5394,NORTH DAKOTA,Grafton,4055.0,7,6,1
5395,NORTH DAKOTA,Grand Forks,56253.0,114,94,20
5396,NORTH DAKOTA,Harvey,1568.0,4,4,0
5397,NORTH DAKOTA,Hazen,2322.0,5,5,0
5398,NORTH DAKOTA,Jamestown,14879.0,31,27,4
5399,NORTH DAKOTA,Kenmare,1019.0,2,2,0
5400,NORTH DAKOTA,Killdeer,1209.0,5,5,0
5401,NORTH DAKOTA,Lamoure,884.0,1,1,0
5402,NORTH DAKOTA,Lincoln,4052.0,8,8,0
5403,NORTH DAKOTA,Lisbon,2002.0,4,4,0
5404,NORTH DAKOTA,Mandan,23292.0,47,40,7
5405,NORTH DAKOTA,Medora,125.0,2,2,0
5406,NORTH DAKOTA,Minot,48086.0,88,75,13
5407,NORTH DAKOTA,Napoleon,756.0,1,1,0
5408,NORTH DAKOTA,New Town,2706.0,7,6,1
5409,NORTH DAKOTA,Northwood,879.0,2,2,0
5410,NORTH DAKOTA,Oakes,1639.0,3,3,0
5411,NORTH DAKOTA,Powers Lake,284.0,2,2,0
5412,NORTH DAKOTA,Ray,989.0,1,1,0
5413,NORTH DAKOTA,Rolette,585.0,2,2,0
5414,NORTH DAKOTA,Rolla,1271.0,4,4,0
5415,NORTH DAKOTA,Rugby,2538.0,4,4,0
5416,NORTH DAKOTA,Stanley,2885.0,4,4,0
5417,NORTH DAKOTA,Steele,701.0,1,1,0
5418,NORTH DAKOTA,Surrey,1460.0,2,2,0
5419,NORTH DAKOTA,Thompson,1031.0,1,1,0
5420,NORTH DAKOTA,Tioga,1405.0,6,5,1
5421,NORTH DAKOTA,Valley City,6268.0,17,15,2
5422,NORTH DAKOTA,Wahpeton,7725.0,18,16,2
5423,NORTH DAKOTA,Watford City,9301.0,27,21,6
5424,NORTH DAKOTA,West Fargo,39704.0,81,68,13
5425,NORTH DAKOTA,Williston,31680.0,91,75,16
5426,NORTH DAKOTA,Wishek,858.0,2,2,0
5427,OHIO,Akron,195701.0,488,451,37
5428,OHIO,Amberley Village,3538.0,23,18,5
5429,OHIO,Amherst,12425.0,30,21,9
5430,OHIO,Andover,1083.0,3,3,0
5431,OHIO,Arcanum,1993.0,4,4,0
5432,OHIO,Archbold,4286.0,11,11,0
5433,OHIO,Ashland,19919.0,36,30,6
5434,OHIO,Athens,24638.0,30,23,7
5435,OHIO,Aurora,16568.0,37,29,8
5436,OHIO,Avon Lake,25040.0,34,29,5
5437,OHIO,Bainbridge Township,11395.0,27,23,4
5438,OHIO,"Bath Township, Summit County",9606.0,27,21,6
5439,OHIO,Beachwood,11580.0,66,46,20
5440,OHIO,Beavercreek,48282.0,63,47,16
5441,OHIO,Beaver Township,6321.0,17,13,4
5442,OHIO,Bedford Heights,10430.0,38,29,9
5443,OHIO,Bellefontaine,13131.0,37,30,7
5444,OHIO,Bellville,1937.0,6,6,0
5445,OHIO,Belpre,6348.0,15,10,5
5446,OHIO,Berea,18563.0,34,31,3
5447,OHIO,Bethel,2837.0,5,4,1
5448,OHIO,Blue Ash,12525.0,42,34,8
5449,OHIO,Bluffton,4002.0,9,9,0
5450,OHIO,Bowling Green,31537.0,50,38,12
5451,OHIO,Brunswick,35132.0,49,40,9
5452,OHIO,Butler Township,7835.0,21,20,1
5453,OHIO,Canal Fulton,5396.0,10,9,1
5454,OHIO,Canfield,7104.0,27,19,8
5455,OHIO,Canton,69623.0,199,159,40
5456,OHIO,Carey,3527.0,13,9,4
5457,OHIO,Catawba Island Township,3495.0,5,5,0
5458,OHIO,Celina,10440.0,23,18,5
5459,OHIO,Centerville,23669.0,55,40,15
5460,OHIO,Circleville,14226.0,30,22,8
5461,OHIO,Cleveland,379313.0,1696,1475,221
5462,OHIO,Cleveland Heights,43608.0,91,87,4
5463,OHIO,Colerain Township,59223.0,58,49,9
5464,OHIO,Columbiana,6276.0,18,14,4
5465,OHIO,Copley Township,17233.0,23,22,1
5466,OHIO,Dayton,139671.0,395,355,40
5467,OHIO,Defiance,16415.0,34,29,5
5468,OHIO,Delaware,43469.0,62,54,8
5469,OHIO,Delhi Township,29785.0,40,31,9
5470,OHIO,Dublin,50236.0,118,69,49
5471,OHIO,East Cleveland,16810.0,51,40,11
5472,OHIO,East Liverpool,10430.0,21,16,5
5473,OHIO,Eaton,8098.0,17,16,1
5474,OHIO,Elida,1803.0,2,2,0
5475,OHIO,Elmore,1396.0,5,5,0
5476,OHIO,Englewood,13507.0,27,21,6
5477,OHIO,Evendale,2707.0,22,20,2
5478,OHIO,Fairborn,34076.0,78,52,26
5479,OHIO,Fairfax,1702.0,11,10,1
5480,OHIO,Fairfield,42608.0,85,63,22
5481,OHIO,Fairfield Township,23206.0,25,23,2
5482,OHIO,Findlay,40803.0,80,61,19
5483,OHIO,Forest Park,18518.0,43,36,7
5484,OHIO,Fort Loramie,1541.0,2,2,0
5485,OHIO,Fort Recovery,1471.0,3,3,0
5486,OHIO,Fostoria,13172.0,26,22,4
5487,OHIO,Galion,9865.0,23,19,4
5488,OHIO,"German Township, Montgomery County",2899.0,6,6,0
5489,OHIO,Greenhills,3548.0,13,11,2
5490,OHIO,Groveport,5642.0,26,25,1
5491,OHIO,Hiram,1092.0,3,3,0
5492,OHIO,Hubbard,7320.0,14,14,0
5493,OHIO,Huber Heights,38244.0,72,53,19
5494,OHIO,Hudson,22170.0,37,30,7
5495,OHIO,Ironton,10354.0,17,16,1
5496,OHIO,"Jackson Township, Mahoning County",1993.0,8,8,0
5497,OHIO,"Jackson Township, Stark County",40215.0,56,48,8
5498,OHIO,Jamestown,2157.0,5,5,0
5499,OHIO,Kenton,8204.0,17,17,0
5500,OHIO,Lake Township,8358.0,17,17,0
5501,OHIO,Lancaster,41152.0,78,61,17
5502,OHIO,Liberty Township,11291.0,20,19,1
5503,OHIO,Logan,6918.0,23,19,4
5504,OHIO,Lordstown,3227.0,14,10,4
5505,OHIO,Lyndhurst,13258.0,37,29,8
5506,OHIO,Macedonia,12120.0,32,24,8
5507,OHIO,Madeira,9340.0,15,14,1
5508,OHIO,"Madison Township, Franklin County",20118.0,16,15,1
5509,OHIO,Mansfield,45971.0,112,77,35
5510,OHIO,Mariemont,3442.0,12,11,1
5511,OHIO,Maumee,13541.0,38,36,2
5512,OHIO,Medina,25905.0,48,39,9
5513,OHIO,Medina Township,9176.0,9,9,0
5514,OHIO,Mentor-on-the-Lake,7372.0,14,9,5
5515,OHIO,Miamisburg,20112.0,40,38,2
5516,OHIO,"Miami Township, Clermont County",43182.0,44,41,3
5517,OHIO,Middletown,48944.0,105,69,36
5518,OHIO,Milan,1337.0,3,3,0
5519,OHIO,Minerva Park,1322.0,10,9,1
5520,OHIO,Monroeville,1333.0,5,5,0
5521,OHIO,Montgomery,10943.0,24,21,3
5522,OHIO,Montpelier,3893.0,10,9,1
5523,OHIO,Munroe Falls,5054.0,9,8,1
5524,OHIO,Napoleon,8088.0,23,18,5
5525,OHIO,Navarre,1788.0,6,6,0
5526,OHIO,New Albany,11449.0,37,26,11
5527,OHIO,Newark,50980.0,87,76,11
5528,OHIO,New Bremen,2944.0,8,8,0
5529,OHIO,New Knoxville,860.0,1,1,0
5530,OHIO,New Lexington,4667.0,8,7,1
5531,OHIO,Newton Falls,4413.0,6,6,0
5532,OHIO,Niles,17943.0,42,36,6
5533,OHIO,North Olmsted,31224.0,58,43,15
5534,OHIO,North Randall,984.0,11,11,0
5535,OHIO,North Ridgeville,35708.0,49,42,7
5536,OHIO,Norton,11894.0,17,16,1
5537,OHIO,Norwalk,16752.0,32,25,7
5538,OHIO,Oberlin,8107.0,25,17,8
5539,OHIO,Orrville,8442.0,17,16,1
5540,OHIO,Ottawa,4310.0,8,8,0
5541,OHIO,Owensville,836.0,4,4,0
5542,OHIO,Pandora,1097.0,2,2,0
5543,OHIO,Perkins Township,11552.0,21,20,1
5544,OHIO,Perrysburg Township,13072.0,32,24,8
5545,OHIO,"Perry Township, Stark County",27970.0,27,24,3
5546,OHIO,Pierce Township,15178.0,19,18,1
5547,OHIO,Plain City,4820.0,12,11,1
5548,OHIO,Poland Township,11703.0,13,13,0
5549,OHIO,Port Clinton,6113.0,20,16,4
5550,OHIO,Portsmouth,19702.0,40,37,3
5551,OHIO,Powell,13591.0,21,19,2
5552,OHIO,Rockford,1104.0,6,6,0
5553,OHIO,Salem,11441.0,26,23,3
5554,OHIO,Salineville,1203.0,2,2,0
5555,OHIO,Seaman,882.0,2,2,0
5556,OHIO,Sebring,4133.0,13,8,5
5557,OHIO,Seven Hills,11600.0,18,17,1
5558,OHIO,Shaker Heights,26772.0,80,65,15
5559,OHIO,Sharonville,13685.0,48,37,11
5560,OHIO,Shawnee Hills,852.0,5,5,0
5561,OHIO,Shawnee Township,12072.0,19,13,6
5562,OHIO,Sheffield Village,4634.0,21,14,7
5563,OHIO,Sidney,20217.0,46,35,11
5564,OHIO,Silver Lake,2480.0,9,8,1
5565,OHIO,Solon,22740.0,84,48,36
5566,OHIO,Springboro,19429.0,36,31,5
5567,OHIO,"Springfield Township, Hamilton County",35873.0,52,43,9
5568,OHIO,Steubenville,17482.0,44,39,5
5569,OHIO,St. Henry,2587.0,3,3,0
5570,OHIO,Sugarcreek,2228.0,8,8,0
5571,OHIO,Sugarcreek Township,8536.0,21,17,4
5572,OHIO,Sylvania,19560.0,36,31,5
5573,OHIO,Tallmadge,17532.0,27,23,4
5574,OHIO,Toledo,269941.0,632,580,52
5575,OHIO,Uhrichsville,5287.0,9,9,0
5576,OHIO,Uniontown,3306.0,12,10,2
5577,OHIO,"Union Township, Clermont County",48994.0,65,51,14
5578,OHIO,University Heights,12638.0,30,28,2
5579,OHIO,Urbana,11368.0,17,17,0
5580,OHIO,"Valley View, Cuyahoga County",1992.0,18,16,2
5581,OHIO,Vandalia,14960.0,42,31,11
5582,OHIO,Van Wert,10594.0,27,21,6
5583,OHIO,Wadsworth,24656.0,40,31,9
5584,OHIO,Warren,38193.0,65,60,5
5585,OHIO,Washington Court House,14189.0,27,21,6
5586,OHIO,Wauseon,7410.0,19,14,5
5587,OHIO,Westerville,41985.0,100,72,28
5588,OHIO,West Salem,1531.0,1,1,0
5589,OHIO,West Union,3137.0,4,3,1
5590,OHIO,Whitehall,18985.0,64,51,13
5591,OHIO,Whitehouse,5020.0,11,11,0
5592,OHIO,Wickliffe,12725.0,39,30,9
5593,OHIO,Willoughby Hills,9545.0,28,24,4
5594,OHIO,Willowick,14056.0,30,22,8
5595,OHIO,Wooster,26160.0,46,41,5
5596,OHIO,Xenia,27228.0,69,43,26
5597,OHIO,Youngstown,63538.0,173,133,40
5598,OHIO,Zanesville,25166.0,95,55,40
5599,OKLAHOMA,Achille,556.0,5,4,1
5600,OKLAHOMA,Ada,17280.0,36,33,3
5601,OKLAHOMA,Adair,804.0,4,4,0
5602,OKLAHOMA,Allen,930.0,1,1,0
5603,OKLAHOMA,Altus,18007.0,54,41,13
5604,OKLAHOMA,Alva,4867.0,12,10,2
5605,OKLAHOMA,Amber,502.0,1,1,0
5606,OKLAHOMA,Anadarko,6444.0,22,21,1
5607,OKLAHOMA,Antlers,2286.0,11,6,5
5608,OKLAHOMA,Apache,1385.0,3,3,0
5609,OKLAHOMA,Ardmore,24795.0,62,46,16
5610,OKLAHOMA,Arkoma,1885.0,4,2,2
5611,OKLAHOMA,Atoka,3038.0,19,17,2
5612,OKLAHOMA,Avant,311.0,1,1,0
5613,OKLAHOMA,Barnsdall,1123.0,4,4,0
5614,OKLAHOMA,Bartlesville,36688.0,85,61,24
5615,OKLAHOMA,Beaver,1350.0,1,1,0
5616,OKLAHOMA,Beggs,1225.0,7,1,6
5617,OKLAHOMA,Bennington,378.0,1,1,0
5618,OKLAHOMA,Bernice,581.0,1,1,0
5619,OKLAHOMA,Bethany,19209.0,36,27,9
5620,OKLAHOMA,Big Cabin,250.0,3,2,1
5621,OKLAHOMA,Binger,624.0,1,1,0
5622,OKLAHOMA,Bixby,29327.0,49,37,12
5623,OKLAHOMA,Blackwell,6474.0,20,13,7
5624,OKLAHOMA,Blair,729.0,1,1,0
5625,OKLAHOMA,Blanchard,9303.0,10,10,0
5626,OKLAHOMA,Boise City,1071.0,1,1,0
5627,OKLAHOMA,Bokchito,711.0,7,6,1
5628,OKLAHOMA,Bokoshe,495.0,3,3,0
5629,OKLAHOMA,Boley,1165.0,2,1,1
5630,OKLAHOMA,Bristow,4174.0,16,11,5
5631,OKLAHOMA,Broken Arrow,112990.0,213,151,62
5632,OKLAHOMA,Broken Bow,4085.0,22,17,5
5633,OKLAHOMA,Burns Flat,1865.0,4,4,0
5634,OKLAHOMA,Cache,2824.0,8,6,2
5635,OKLAHOMA,Caddo,1125.0,4,4,0
5636,OKLAHOMA,Calera,2440.0,11,10,1
5637,OKLAHOMA,Calumet,623.0,1,1,0
5638,OKLAHOMA,Calvin,267.0,2,1,1
5639,OKLAHOMA,Caney,202.0,4,3,1
5640,OKLAHOMA,Carnegie,1634.0,10,6,4
5641,OKLAHOMA,Carney,620.0,2,2,0
5642,OKLAHOMA,Cashion,943.0,3,3,0
5643,OKLAHOMA,Catoosa,6876.0,19,16,3
5644,OKLAHOMA,Cement,468.0,1,1,0
5645,OKLAHOMA,Chandler,3080.0,12,8,4
5646,OKLAHOMA,Chattanooga,457.0,2,1,1
5647,OKLAHOMA,Checotah,3051.0,13,10,3
5648,OKLAHOMA,Chelsea,1868.0,4,4,0
5649,OKLAHOMA,Cherokee,1492.0,3,3,0
5650,OKLAHOMA,Chickasha,16410.0,31,23,8
5651,OKLAHOMA,Choctaw,12938.0,19,18,1
5652,OKLAHOMA,Chouteau,2111.0,9,8,1
5653,OKLAHOMA,Claremore,18961.0,47,39,8
5654,OKLAHOMA,Clayton,771.0,11,6,5
5655,OKLAHOMA,Cleveland,3101.0,5,5,0
5656,OKLAHOMA,Clinton,8943.0,23,14,9
5657,OKLAHOMA,Coalgate,1830.0,6,6,0
5658,OKLAHOMA,Colbert,1281.0,3,3,0
5659,OKLAHOMA,Colcord,854.0,6,6,0
5660,OKLAHOMA,Collinsville,7765.0,23,14,9
5661,OKLAHOMA,Comanche,1540.0,5,5,0
5662,OKLAHOMA,Commerce,2482.0,5,5,0
5663,OKLAHOMA,Cordell,2689.0,5,5,0
5664,OKLAHOMA,Covington,533.0,1,1,0
5665,OKLAHOMA,Coweta,10297.0,23,16,7
5666,OKLAHOMA,Crescent,1596.0,7,5,2
5667,OKLAHOMA,Cushing,7558.0,23,16,7
5668,OKLAHOMA,Cyril,997.0,1,1,0
5669,OKLAHOMA,Davenport,808.0,1,1,0
5670,OKLAHOMA,Davis,2874.0,13,12,1
5671,OKLAHOMA,Del City,21665.0,48,38,10
5672,OKLAHOMA,Dewar,843.0,3,3,0
5673,OKLAHOMA,Dewey,3411.0,12,10,2
5674,OKLAHOMA,Dibble,884.0,3,2,1
5675,OKLAHOMA,Dickson,1260.0,4,3,1
5676,OKLAHOMA,Disney,302.0,1,1,0
5677,OKLAHOMA,Drumright,2805.0,6,6,0
5678,OKLAHOMA,Duncan,22145.0,62,45,17
5679,OKLAHOMA,Durant,19518.0,41,37,4
5680,OKLAHOMA,Earlsboro,625.0,3,2,1
5681,OKLAHOMA,Edmond,96861.0,158,121,37
5682,OKLAHOMA,Eldorado,397.0,1,1,0
5683,OKLAHOMA,Elgin,3359.0,5,5,0
5684,OKLAHOMA,Elk City,11326.0,39,26,13
5685,OKLAHOMA,Elmore City,753.0,5,4,1
5686,OKLAHOMA,El Reno,21018.0,49,34,15
5687,OKLAHOMA,Enid,49545.0,111,82,29
5688,OKLAHOMA,Erick,969.0,1,1,0
5689,OKLAHOMA,Eufaula,2841.0,10,10,0
5690,OKLAHOMA,Fairfax,1229.0,3,1,2
5691,OKLAHOMA,Fairland,1021.0,3,2,1
5692,OKLAHOMA,Fairview,2580.0,8,5,3
5693,OKLAHOMA,Fletcher,1137.0,2,2,0
5694,OKLAHOMA,Forest Park,1078.0,2,2,0
5695,OKLAHOMA,Fort Cobb,604.0,1,1,0
5696,OKLAHOMA,Fort Gibson,3912.0,14,13,1
5697,OKLAHOMA,Foyil,388.0,1,1,0
5698,OKLAHOMA,Frederick,3490.0,7,5,2
5699,OKLAHOMA,Gans,294.0,2,2,0
5700,OKLAHOMA,Garber,802.0,1,1,0
5701,OKLAHOMA,Geary,1271.0,12,7,5
5702,OKLAHOMA,Geronimo,1220.0,1,1,0
5703,OKLAHOMA,Glenpool,14385.0,32,24,8
5704,OKLAHOMA,Goodwell,1261.0,2,2,0
5705,OKLAHOMA,Gore,943.0,11,5,6
5706,OKLAHOMA,Grandfield,922.0,1,1,0
5707,OKLAHOMA,Granite,1946.0,4,4,0
5708,OKLAHOMA,Grove,7242.0,31,22,9
5709,OKLAHOMA,Guthrie,11968.0,31,23,8
5710,OKLAHOMA,Guymon,10960.0,18,16,2
5711,OKLAHOMA,Haileyville,740.0,4,3,1
5712,OKLAHOMA,Hammon,554.0,1,1,0
5713,OKLAHOMA,Harrah,6805.0,11,10,1
5714,OKLAHOMA,Hartshorne,1928.0,6,4,2
5715,OKLAHOMA,Haskell,1949.0,7,7,0
5716,OKLAHOMA,Haworth,294.0,1,1,0
5717,OKLAHOMA,Healdton,2684.0,4,4,0
5718,OKLAHOMA,Heavener,3285.0,10,9,1
5719,OKLAHOMA,Hennessey,2234.0,8,4,4
5720,OKLAHOMA,Henryetta,5464.0,17,12,5
5721,OKLAHOMA,Hinton,3221.0,5,5,0
5722,OKLAHOMA,Hobart,3405.0,13,7,6
5723,OKLAHOMA,Holdenville,5394.0,3,3,0
5724,OKLAHOMA,Hollis,1794.0,8,5,3
5725,OKLAHOMA,Hominy,3332.0,10,5,5
5726,OKLAHOMA,Hooker,1834.0,2,2,0
5727,OKLAHOMA,Howe,786.0,1,1,0
5728,OKLAHOMA,Hugo,5047.0,27,19,8
5729,OKLAHOMA,Hulbert,579.0,4,4,0
5730,OKLAHOMA,Hydro,933.0,3,3,0
5731,OKLAHOMA,Idabel,6864.0,27,21,6
5732,OKLAHOMA,Inola,1793.0,8,7,1
5733,OKLAHOMA,Jay,2536.0,14,9,5
5734,OKLAHOMA,Jenks,25111.0,32,24,8
5735,OKLAHOMA,Jennings,355.0,1,1,0
5736,OKLAHOMA,Jones,3280.0,6,6,0
5737,OKLAHOMA,Kansas,805.0,5,5,0
5738,OKLAHOMA,Kellyville,1127.0,2,2,0
5739,OKLAHOMA,Keota,544.0,2,2,0
5740,OKLAHOMA,Kiefer,2072.0,5,5,0
5741,OKLAHOMA,Kingfisher,4919.0,16,15,1
5742,OKLAHOMA,Kingston,1698.0,6,6,0
5743,OKLAHOMA,Kiowa,671.0,4,4,0
5744,OKLAHOMA,Konawa,1184.0,5,4,1
5745,OKLAHOMA,Krebs,1995.0,9,7,2
5746,OKLAHOMA,Langley,821.0,4,4,0
5747,OKLAHOMA,Langston,1882.0,2,1,1
5748,OKLAHOMA,Laverne,1293.0,1,1,0
5749,OKLAHOMA,Lawton,92711.0,209,165,44
5750,OKLAHOMA,Lexington,2190.0,7,4,3
5751,OKLAHOMA,Lindsay,2767.0,9,5,4
5752,OKLAHOMA,Locust Grove,1392.0,7,6,1
5753,OKLAHOMA,Lone Grove,5225.0,10,7,3
5754,OKLAHOMA,Luther,1842.0,5,5,0
5755,OKLAHOMA,Madill,4096.0,14,11,3
5756,OKLAHOMA,Mangum,2662.0,10,5,5
5757,OKLAHOMA,Mannford,3191.0,11,8,3
5758,OKLAHOMA,Marble City,249.0,2,1,1
5759,OKLAHOMA,Marietta,2764.0,8,8,0
5760,OKLAHOMA,Marlow,4393.0,9,9,0
5761,OKLAHOMA,Maud,1059.0,4,3,1
5762,OKLAHOMA,Maysville,1199.0,8,6,2
5763,OKLAHOMA,McAlester,17729.0,43,40,3
5764,OKLAHOMA,McLoud,4828.0,10,9,1
5765,OKLAHOMA,Medford,939.0,3,3,0
5766,OKLAHOMA,Medicine Park,469.0,2,2,0
5767,OKLAHOMA,Meeker,1139.0,5,5,0
5768,OKLAHOMA,Miami,12885.0,30,29,1
5769,OKLAHOMA,Midwest City,57901.0,121,97,24
5770,OKLAHOMA,Minco,1646.0,2,2,0
5771,OKLAHOMA,Moore,63927.0,98,88,10
5772,OKLAHOMA,Mooreland,1135.0,4,3,1
5773,OKLAHOMA,Morris,1404.0,4,4,0
5774,OKLAHOMA,Mounds,1253.0,2,2,0
5775,OKLAHOMA,Mountain View,739.0,1,1,0
5776,OKLAHOMA,Muldrow,3260.0,13,8,5
5777,OKLAHOMA,Muskogee,36598.0,91,83,8
5778,OKLAHOMA,Mustang,24822.0,35,25,10
5779,OKLAHOMA,Newcastle,11788.0,26,17,9
5780,OKLAHOMA,Newkirk,2147.0,4,4,0
5781,OKLAHOMA,Nichols Hills,3982.0,23,16,7
5782,OKLAHOMA,Nicoma Park,2486.0,7,7,0
5783,OKLAHOMA,Ninnekah,1046.0,4,3,1
5784,OKLAHOMA,Noble,7329.0,19,13,6
5785,OKLAHOMA,Norman,127304.0,225,162,63
5786,OKLAHOMA,North Enid,923.0,4,4,0
5787,OKLAHOMA,Nowata,3527.0,9,6,3
5788,OKLAHOMA,Oilton,1011.0,3,3,0
5789,OKLAHOMA,Okarche,1346.0,5,5,0
5790,OKLAHOMA,Okeene,1130.0,8,2,6
5791,OKLAHOMA,Okemah,3031.0,15,10,5
5792,OKLAHOMA,Oklahoma City,670872.0,1378,1105,273
5793,OKLAHOMA,Okmulgee,11531.0,23,20,3
5794,OKLAHOMA,Olustee,545.0,1,1,0
5795,OKLAHOMA,Oologah,1182.0,5,5,0
5796,OKLAHOMA,Owasso,38057.0,82,63,19
5797,OKLAHOMA,Panama,1353.0,3,3,0
5798,OKLAHOMA,Paoli,612.0,3,3,0
5799,OKLAHOMA,Pauls Valley,6101.0,20,15,5
5800,OKLAHOMA,Pawhuska,3341.0,12,7,5
5801,OKLAHOMA,Pawnee,2092.0,6,6,0
5802,OKLAHOMA,Perkins,2798.0,7,7,0
5803,OKLAHOMA,Perry,4804.0,20,14,6
5804,OKLAHOMA,Piedmont,9385.0,11,9,2
5805,OKLAHOMA,Pocola,4163.0,14,9,5
5806,OKLAHOMA,Ponca City,23307.0,71,50,21
5807,OKLAHOMA,Pond Creek,848.0,2,1,1
5808,OKLAHOMA,Porum,696.0,4,4,0
5809,OKLAHOMA,Poteau,8942.0,33,26,7
5810,OKLAHOMA,Prague,2362.0,13,8,5
5811,OKLAHOMA,Pryor Creek,9377.0,34,29,5
5812,OKLAHOMA,Purcell,6409.0,22,17,5
5813,OKLAHOMA,Quinton,978.0,8,6,2
5814,OKLAHOMA,Ramona,557.0,5,4,1
5815,OKLAHOMA,Ratliff City,117.0,2,2,0
5816,OKLAHOMA,Rattan,293.0,4,4,0
5817,OKLAHOMA,Ringling,937.0,1,1,0
5818,OKLAHOMA,Roland,4112.0,11,7,4
5819,OKLAHOMA,Rush Springs,1254.0,5,5,0
5820,OKLAHOMA,Salina,1396.0,7,6,1
5821,OKLAHOMA,Sallisaw,8405.0,31,23,8
5822,OKLAHOMA,Sand Springs,20139.0,41,31,10
5823,OKLAHOMA,Sapulpa,21535.0,60,45,15
5824,OKLAHOMA,Savanna,646.0,10,7,3
5825,OKLAHOMA,Sawyer,326.0,2,1,1
5826,OKLAHOMA,Sayre,4443.0,11,6,5
5827,OKLAHOMA,Seiling,838.0,1,1,0
5828,OKLAHOMA,Seminole,6993.0,13,12,1
5829,OKLAHOMA,Shady Point,994.0,2,2,0
5830,OKLAHOMA,Shattuck,1234.0,1,1,0
5831,OKLAHOMA,Shawnee,31724.0,86,73,13
5832,OKLAHOMA,Skiatook,8189.0,27,21,6
5833,OKLAHOMA,Snyder,1270.0,3,3,0
5834,OKLAHOMA,South Coffeyville,725.0,4,4,0
5835,OKLAHOMA,Spavinaw,432.0,1,1,0
5836,OKLAHOMA,Spencer,3962.0,7,5,2
5837,OKLAHOMA,Sperry,1370.0,4,4,0
5838,OKLAHOMA,Spiro,2153.0,4,3,1
5839,OKLAHOMA,Sterling,775.0,2,2,0
5840,OKLAHOMA,Stigler,2698.0,13,8,5
5841,OKLAHOMA,Stillwater,50786.0,127,84,43
5842,OKLAHOMA,Stilwell,4014.0,19,13,6
5843,OKLAHOMA,Stratford,1522.0,4,4,0
5844,OKLAHOMA,Stringtown,406.0,6,5,1
5845,OKLAHOMA,Stroud,2705.0,14,9,5
5846,OKLAHOMA,Sulphur,4995.0,11,9,2
5847,OKLAHOMA,Tahlequah,17126.0,44,39,5
5848,OKLAHOMA,Talala,270.0,1,1,0
5849,OKLAHOMA,Talihina,1074.0,9,6,3
5850,OKLAHOMA,Tecumseh,6656.0,10,10,0
5851,OKLAHOMA,Texhoma,900.0,2,2,0
5852,OKLAHOMA,Thackerville,527.0,1,1,0
5853,OKLAHOMA,The Village,9709.0,29,23,6
5854,OKLAHOMA,Thomas,1178.0,2,2,0
5855,OKLAHOMA,Tipton,747.0,1,1,0
5856,OKLAHOMA,Tishomingo,2992.0,8,7,1
5857,OKLAHOMA,Tonkawa,2934.0,13,8,5
5858,OKLAHOMA,Tryon,497.0,2,1,1
5859,OKLAHOMA,Tulsa,404255.0,1008,801,207
5860,OKLAHOMA,Tupelo,306.0,4,3,1
5861,OKLAHOMA,Tushka,395.0,2,2,0
5862,OKLAHOMA,Tuttle,7796.0,21,15,6
5863,OKLAHOMA,Tyrone,741.0,2,1,1
5864,OKLAHOMA,Union City,2273.0,12,8,4
5865,OKLAHOMA,Valley Brook,767.0,7,5,2
5866,OKLAHOMA,Valliant,740.0,4,3,1
5867,OKLAHOMA,Velma,593.0,1,1,0
5868,OKLAHOMA,Verden,537.0,3,3,0
5869,OKLAHOMA,Verdigris,4810.0,8,7,1
5870,OKLAHOMA,Vian,1345.0,5,5,0
5871,OKLAHOMA,Vici,685.0,1,1,0
5872,OKLAHOMA,Vinita,5264.0,18,13,5
5873,OKLAHOMA,Wagoner,9479.0,21,16,5
5874,OKLAHOMA,Walters,2336.0,3,3,0
5875,OKLAHOMA,Warner,1570.0,5,5,0
5876,OKLAHOMA,Warr Acres,10105.0,30,25,5
5877,OKLAHOMA,Washington,605.0,2,1,1
5878,OKLAHOMA,Watonga,2823.0,8,6,2
5879,OKLAHOMA,Watts,305.0,3,2,1
5880,OKLAHOMA,Waukomis,1290.0,4,4,0
5881,OKLAHOMA,Waurika,1847.0,1,1,0
5882,OKLAHOMA,Waynoka,899.0,4,4,0
5883,OKLAHOMA,Weatherford,12013.0,42,27,15
5884,OKLAHOMA,Webbers Falls,588.0,6,5,1
5885,OKLAHOMA,Weleetka,931.0,7,5,2
5886,OKLAHOMA,Wellston,776.0,3,3,0
5887,OKLAHOMA,West Siloam Springs,861.0,12,11,1
5888,OKLAHOMA,Westville,1523.0,9,6,3
5889,OKLAHOMA,Wetumka,1177.0,14,2,12
5890,OKLAHOMA,Wewoka,3198.0,5,5,0
5891,OKLAHOMA,Wilburton,2542.0,7,6,1
5892,OKLAHOMA,Wilson,1705.0,4,4,0
5893,OKLAHOMA,Wister,1060.0,2,2,0
5894,OKLAHOMA,Woodward,11871.0,26,22,4
5895,OKLAHOMA,Wright City,727.0,3,2,1
5896,OKLAHOMA,Wyandotte,321.0,10,9,1
5897,OKLAHOMA,Wynnewood,2203.0,7,6,1
5898,OKLAHOMA,Wynona,434.0,1,1,0
5899,OKLAHOMA,Yale,1211.0,7,4,3
5900,OKLAHOMA,Yukon,29467.0,70,47,23
5901,OREGON,Albany,56746.0,78,48,30
5902,OREGON,Ashland,21308.0,30,24,6
5903,OREGON,Astoria,10086.0,26,16,10
5904,OREGON,Aumsville,4266.0,7,6,1
5905,OREGON,Baker City,9882.0,13,12,1
5906,OREGON,Bandon,3181.0,10,6,4
5907,OREGON,Banks,2058.0,2,2,0
5908,OREGON,Beaverton,99886.0,175,131,44
5909,OREGON,Bend,104833.0,132,97,35
5910,OREGON,Black Butte,,9,7,2
5911,OREGON,Boardman,3855.0,12,11,1
5912,OREGON,Brookings,6583.0,23,16,7
5913,OREGON,Burns,2791.0,6,4,2
5914,OREGON,Canby,18161.0,29,25,4
5915,OREGON,Cannon Beach,1788.0,10,8,2
5916,OREGON,Carlton,2204.0,4,4,0
5917,OREGON,Central Point,19313.0,34,27,7
5918,OREGON,Coburg,1213.0,5,5,0
5919,OREGON,Columbia City,2034.0,2,2,0
5920,OREGON,Coos Bay,16378.0,39,25,14
5921,OREGON,Coquille,3966.0,8,7,1
5922,OREGON,Cornelius,13241.0,15,14,1
5923,OREGON,Corvallis,59585.0,110,71,39
5924,OREGON,Cottage Grove,10606.0,30,16,14
5925,OREGON,Dallas,17630.0,26,21,5
5926,OREGON,Eagle Point,9782.0,12,11,1
5927,OREGON,Enterprise,1999.0,4,4,0
5928,OREGON,Eugene,175007.0,302,187,115
5929,OREGON,Florence,9285.0,23,16,7
5930,OREGON,Forest Grove,25890.0,33,28,5
5931,OREGON,Gaston,723.0,1,1,0
5932,OREGON,Gearhart,1672.0,2,2,0
5933,OREGON,Gervais,2805.0,5,5,0
5934,OREGON,Gladstone,12506.0,18,15,3
5935,OREGON,Gold Beach,2355.0,7,6,1
5936,OREGON,Grants Pass,38672.0,81,54,27
5937,OREGON,Gresham,110448.0,141,115,26
5938,OREGON,Hermiston,17898.0,32,28,4
5939,OREGON,Hillsboro,113053.0,182,134,48
5940,OREGON,Hines,1534.0,4,3,1
5941,OREGON,Hood River,7848.0,16,14,2
5942,OREGON,Hubbard,3639.0,7,6,1
5943,OREGON,Independence,11129.0,19,14,5
5944,OREGON,Jacksonville,2875.0,7,6,1
5945,OREGON,John Day,1661.0,5,4,1
5946,OREGON,Junction City,6303.0,13,7,6
5947,OREGON,Keizer,39913.0,46,38,8
5948,OREGON,King City,4446.0,7,6,1
5949,OREGON,Klamath Falls,22960.0,38,34,4
5950,OREGON,La Grande,13431.0,32,17,15
5951,OREGON,Lake Oswego,40138.0,75,45,30
5952,OREGON,Lebanon,17772.0,40,27,13
5953,OREGON,Lincoln City,9391.0,42,25,17
5954,OREGON,Madras,7191.0,12,11,1
5955,OREGON,Malin,841.0,1,1,0
5956,OREGON,Manzanita,678.0,4,4,0
5957,OREGON,McMinnville,35498.0,46,40,6
5958,OREGON,Medford,84297.0,143,108,35
5959,OREGON,Milton-Freewater,7050.0,16,11,5
5960,OREGON,Milwaukie,21094.0,42,37,5
5961,OREGON,Molalla,9383.0,19,17,2
5962,OREGON,Monmouth,10728.0,15,13,2
5963,OREGON,Mount Angel,3677.0,7,6,1
5964,OREGON,Myrtle Creek,3495.0,9,7,2
5965,OREGON,Myrtle Point,2585.0,6,5,1
5966,OREGON,Newberg-Dundee,24168.0,45,33,12
5967,OREGON,Newport,11247.0,23,16,7
5968,OREGON,North Bend,9751.0,23,16,7
5969,OREGON,North Plains,2219.0,3,3,0
5970,OREGON,Nyssa,3228.0,7,7,0
5971,OREGON,Oakridge,3403.0,6,5,1
5972,OREGON,Ontario,11117.0,28,24,4
5973,OREGON,Oregon City,38602.0,52,44,8
5974,OREGON,Pendleton,16587.0,28,24,4
5975,OREGON,Philomath,5742.0,10,9,1
5976,OREGON,Phoenix,4705.0,10,8,2
5977,OREGON,Pilot Rock,1508.0,2,2,0
5978,OREGON,Portland,664350.0,1040,791,249
5979,OREGON,Port Orford,1175.0,6,6,0
5980,OREGON,Prineville,11541.0,34,23,11
5981,OREGON,Rainier,2032.0,5,4,1
5982,OREGON,Redmond,35230.0,62,48,14
5983,OREGON,Reedsport,4101.0,14,9,5
5984,OREGON,Rogue River,2363.0,6,5,1
5985,OREGON,Roseburg,23564.0,41,37,4
5986,OREGON,Salem,178106.0,245,180,65
5987,OREGON,Sandy,11773.0,18,14,4
5988,OREGON,Scappoose,7715.0,8,7,1
5989,OREGON,Seaside,6971.0,29,20,9
5990,OREGON,Sherwood,19882.0,28,24,4
5991,OREGON,Silverton,10764.0,18,15,3
5992,OREGON,Springfield,63599.0,86,56,30
5993,OREGON,Stanfield,2113.0,5,5,0
5994,OREGON,Stayton,8314.0,12,11,1
5995,OREGON,St. Helens,14178.0,23,20,3
5996,OREGON,Sunriver,1395.0,12,11,1
5997,OREGON,Sutherlin,8267.0,18,14,4
5998,OREGON,Sweet Home,10136.0,18,12,6
5999,OREGON,Talent,6767.0,8,6,2
6000,OREGON,The Dalles,15643.0,26,22,4
6001,OREGON,Tigard,56914.0,84,69,15
6002,OREGON,Tillamook,5480.0,12,10,2
6003,OREGON,Toledo,3662.0,16,8,8
6004,OREGON,Tualatin,27617.0,45,37,8
6005,OREGON,Turner,2160.0,2,2,0
6006,OREGON,Umatilla,7404.0,15,13,2
6007,OREGON,Vernonia,2309.0,4,3,1
6008,OREGON,Warrenton,5815.0,12,11,1
6009,OREGON,West Linn,26908.0,27,23,4
6010,OREGON,Winston,5558.0,12,11,1
6011,OREGON,Woodburn,26386.0,40,31,9
6012,OREGON,Yamhill,1188.0,6,3,3
6013,PENNSYLVANIA,"Adams Township, Butler County",14234.0,17,17,0
6014,PENNSYLVANIA,"Adams Township, Cambria County",5425.0,5,5,0
6015,PENNSYLVANIA,Alburtis,2674.0,4,4,0
6016,PENNSYLVANIA,Aldan,4149.0,7,5,2
6017,PENNSYLVANIA,Aliquippa,8678.0,13,12,1
6018,PENNSYLVANIA,"Allegheny Township, Blair County",6621.0,10,9,1
6019,PENNSYLVANIA,Allegheny Valley Regional,3212.0,3,3,0
6020,PENNSYLVANIA,Allentown,121819.0,237,216,21
6021,PENNSYLVANIA,Altoona,42707.0,70,62,8
6022,PENNSYLVANIA,Ambridge,6486.0,13,13,0
6023,PENNSYLVANIA,Amity Township,13217.0,15,14,1
6024,PENNSYLVANIA,Annville Township,5086.0,6,5,1
6025,PENNSYLVANIA,Apollo,1494.0,1,1,0
6026,PENNSYLVANIA,Archbald,7060.0,7,7,0
6027,PENNSYLVANIA,Arnold,4756.0,10,10,0
6028,PENNSYLVANIA,Ashland,2654.0,3,3,0
6029,PENNSYLVANIA,Aspinwall,2641.0,6,6,0
6030,PENNSYLVANIA,Aston Township,16762.0,22,20,2
6031,PENNSYLVANIA,Athens,3162.0,7,6,1
6032,PENNSYLVANIA,Athens Township,5028.0,10,10,0
6033,PENNSYLVANIA,Avalon,4485.0,6,6,0
6034,PENNSYLVANIA,Avoca,2600.0,3,3,0
6035,PENNSYLVANIA,Baldwin Borough,19364.0,25,24,1
6036,PENNSYLVANIA,Baldwin Township,1915.0,5,5,0
6037,PENNSYLVANIA,Bally,1261.0,2,2,0
6038,PENNSYLVANIA,Beaver,4193.0,13,12,1
6039,PENNSYLVANIA,Beaver Falls,9329.0,21,19,2
6040,PENNSYLVANIA,Beaver Meadows,829.0,1,1,0
6041,PENNSYLVANIA,Bedford,2651.0,5,5,0
6042,PENNSYLVANIA,Bedminster Township,7286.0,8,7,1
6043,PENNSYLVANIA,Bell Acres,1371.0,5,5,0
6044,PENNSYLVANIA,Bellefonte,6188.0,11,10,1
6045,PENNSYLVANIA,Bellevue,7944.0,14,13,1
6046,PENNSYLVANIA,Bellwood,1741.0,3,3,0
6047,PENNSYLVANIA,Bensalem Township,60496.0,129,102,27
6048,PENNSYLVANIA,Bentleyville,2469.0,1,1,0
6049,PENNSYLVANIA,Berlin,1916.0,1,1,0
6050,PENNSYLVANIA,Bern Township,6897.0,12,12,0
6051,PENNSYLVANIA,Bernville,942.0,1,1,0
6052,PENNSYLVANIA,Bethel Park,32195.0,35,33,2
6053,PENNSYLVANIA,"Bethel Township, Berks County",4163.0,6,5,1
6054,PENNSYLVANIA,Biglerville,1215.0,1,1,0
6055,PENNSYLVANIA,Birdsboro,5128.0,8,7,1
6056,PENNSYLVANIA,Birmingham Township,4175.0,3,3,0
6057,PENNSYLVANIA,Blairsville,3185.0,4,4,0
6058,PENNSYLVANIA,Blair Township,4445.0,5,5,0
6059,PENNSYLVANIA,Blakely,6138.0,15,15,0
6060,PENNSYLVANIA,Blawnox,1373.0,3,3,0
6061,PENNSYLVANIA,Bloomsburg Town,13643.0,23,18,5
6062,PENNSYLVANIA,Bonneauville,1839.0,1,1,0
6063,PENNSYLVANIA,Brackenridge,3099.0,6,6,0
6064,PENNSYLVANIA,Braddock,2096.0,1,1,0
6065,PENNSYLVANIA,Braddock Hills,1764.0,2,2,0
6066,PENNSYLVANIA,Bradford Township,4541.0,5,5,0
6067,PENNSYLVANIA,Branch Township,1718.0,2,2,0
6068,PENNSYLVANIA,"Brecknock Township, Berks County",4695.0,5,5,0
6069,PENNSYLVANIA,Brentwood,9161.0,17,15,2
6070,PENNSYLVANIA,Briar Creek Township,2952.0,5,5,0
6071,PENNSYLVANIA,Bridgeville,4849.0,9,8,1
6072,PENNSYLVANIA,Bridgewater,829.0,4,3,1
6073,PENNSYLVANIA,Brighton Township,8236.0,13,13,0
6074,PENNSYLVANIA,Bristol,9558.0,14,12,2
6075,PENNSYLVANIA,Bristol Township,53188.0,65,57,8
6076,PENNSYLVANIA,Brockway,2011.0,2,2,0
6077,PENNSYLVANIA,Brookhaven,8056.0,8,7,1
6078,PENNSYLVANIA,Brookville,3746.0,8,7,1
6079,PENNSYLVANIA,Brownsville,2190.0,3,3,0
6080,PENNSYLVANIA,Buckingham Township,20301.0,22,20,2
6081,PENNSYLVANIA,Buffalo Township,7529.0,9,9,0
6082,PENNSYLVANIA,Buffalo Valley Regional,12613.0,15,14,1
6083,PENNSYLVANIA,Bushkill Township,8704.0,16,15,1
6084,PENNSYLVANIA,Butler,12760.0,24,23,1
6085,PENNSYLVANIA,"Butler Township, Butler County",16337.0,24,22,2
6086,PENNSYLVANIA,"Butler Township, Schuylkill County",5406.0,5,5,0
6087,PENNSYLVANIA,"Caernarvon Township, Berks County",4200.0,8,7,1
6088,PENNSYLVANIA,California,6641.0,8,7,1
6089,PENNSYLVANIA,Caln Township,14113.0,20,19,1
6090,PENNSYLVANIA,Cambria Township,5698.0,4,4,0
6091,PENNSYLVANIA,Cambridge Springs,2673.0,3,3,0
6092,PENNSYLVANIA,Camp Hill,7921.0,14,12,2
6093,PENNSYLVANIA,Canonsburg,8725.0,19,17,2
6094,PENNSYLVANIA,Canton,1844.0,1,1,0
6095,PENNSYLVANIA,Carlisle,19260.0,34,32,2
6096,PENNSYLVANIA,Carnegie,7729.0,14,13,1
6097,PENNSYLVANIA,Carrolltown,773.0,2,2,0
6098,PENNSYLVANIA,Carroll Valley,3935.0,4,3,1
6099,PENNSYLVANIA,Castle Shannon,8377.0,14,13,1
6100,PENNSYLVANIA,Catasauqua,6623.0,11,10,1
6101,PENNSYLVANIA,Catawissa,1451.0,5,5,0
6102,PENNSYLVANIA,Center Township,11401.0,19,18,1
6103,PENNSYLVANIA,Centerville,3119.0,4,4,0
6104,PENNSYLVANIA,Central Berks Regional,13695.0,21,20,1
6105,PENNSYLVANIA,Central Bucks Regional,15532.0,30,26,4
6106,PENNSYLVANIA,Chambersburg,21334.0,38,35,3
6107,PENNSYLVANIA,Charleroi Regional,6397.0,10,10,0
6108,PENNSYLVANIA,Chester Township,4083.0,13,13,0
6109,PENNSYLVANIA,Chippewa Township,7840.0,9,8,1
6110,PENNSYLVANIA,Christiana,1165.0,6,6,0
6111,PENNSYLVANIA,Churchill,2889.0,9,9,0
6112,PENNSYLVANIA,Clairton,6468.0,13,13,0
6113,PENNSYLVANIA,Clarion,5744.0,10,9,1
6114,PENNSYLVANIA,Clarks Summit,6186.0,5,5,0
6115,PENNSYLVANIA,Clearfield,5744.0,7,7,0
6116,PENNSYLVANIA,Cleona,2240.0,4,4,0
6117,PENNSYLVANIA,Clifton Heights,6700.0,12,11,1
6118,PENNSYLVANIA,Clymer,1253.0,2,2,0
6119,PENNSYLVANIA,Coaldale,2117.0,3,3,0
6120,PENNSYLVANIA,Coatesville,12999.0,30,26,4
6121,PENNSYLVANIA,Cochranton,1056.0,2,2,0
6122,PENNSYLVANIA,Collier Township,8368.0,19,18,1
6123,PENNSYLVANIA,Collingdale,8782.0,14,13,1
6124,PENNSYLVANIA,Columbia,10285.0,21,18,3
6125,PENNSYLVANIA,"Conemaugh Township, Cambria County",1785.0,1,1,0
6126,PENNSYLVANIA,"Conemaugh Township, Somerset County",6761.0,8,7,1
6127,PENNSYLVANIA,Conewango Township,3293.0,4,4,0
6128,PENNSYLVANIA,Conneaut Lake Regional,4697.0,4,4,0
6129,PENNSYLVANIA,Connellsville,7244.0,18,17,1
6130,PENNSYLVANIA,Conway,2034.0,5,5,0
6131,PENNSYLVANIA,Coopersburg,2485.0,7,7,0
6132,PENNSYLVANIA,Coplay,3225.0,5,4,1
6133,PENNSYLVANIA,Coraopolis,5360.0,14,10,4
6134,PENNSYLVANIA,Cornwall,4409.0,7,6,1
6135,PENNSYLVANIA,Corry,6139.0,9,8,1
6136,PENNSYLVANIA,Coudersport,2373.0,3,3,0
6137,PENNSYLVANIA,Covington Township,2260.0,3,3,0
6138,PENNSYLVANIA,Crafton,6114.0,10,9,1
6139,PENNSYLVANIA,Cranberry Township,32563.0,34,31,3
6140,PENNSYLVANIA,Crescent Township,2523.0,6,6,0
6141,PENNSYLVANIA,Cresson,1515.0,1,1,0
6142,PENNSYLVANIA,Cresson Township,2459.0,1,1,0
6143,PENNSYLVANIA,Croyle Township,2177.0,1,1,0
6144,PENNSYLVANIA,"Cumberland Township, Adams County",6245.0,10,10,0
6145,PENNSYLVANIA,"Cumberland Township, Greene County",6041.0,5,4,1
6146,PENNSYLVANIA,Cumru Township,15502.0,28,27,1
6147,PENNSYLVANIA,Curwensville,2342.0,3,3,0
6148,PENNSYLVANIA,Dallas,2757.0,6,6,0
6149,PENNSYLVANIA,Dallas Township,9331.0,14,13,1
6150,PENNSYLVANIA,Dalton,1185.0,3,3,0
6151,PENNSYLVANIA,Danville,4584.0,9,8,1
6152,PENNSYLVANIA,Darby,10705.0,11,10,1
6153,PENNSYLVANIA,Darby Township,9275.0,15,14,1
6154,PENNSYLVANIA,Darlington Township,1835.0,2,2,0
6155,PENNSYLVANIA,Derry,2477.0,3,3,0
6156,PENNSYLVANIA,"Derry Township, Dauphin County",25388.0,40,38,2
6157,PENNSYLVANIA,Donegal Township,3248.0,2,2,0
6158,PENNSYLVANIA,Donora,4523.0,5,5,0
6159,PENNSYLVANIA,Dormont,8187.0,14,13,1
6160,PENNSYLVANIA,"Douglass Township, Berks County",3625.0,6,6,0
6161,PENNSYLVANIA,Downingtown,8475.0,23,19,4
6162,PENNSYLVANIA,Doylestown Township,17335.0,23,21,2
6163,PENNSYLVANIA,Dublin Borough,2113.0,2,2,0
6164,PENNSYLVANIA,DuBois,7240.0,16,15,1
6165,PENNSYLVANIA,Duncansville,1140.0,2,2,0
6166,PENNSYLVANIA,Dunmore,12719.0,21,20,1
6167,PENNSYLVANIA,Dupont,2689.0,2,2,0
6168,PENNSYLVANIA,Duquesne,5528.0,13,13,0
6169,PENNSYLVANIA,Duryea,4903.0,5,5,0
6170,PENNSYLVANIA,East Berlin,1544.0,3,1,2
6171,PENNSYLVANIA,East Brandywine Township,9434.0,16,14,2
6172,PENNSYLVANIA,East Cocalico Township,10834.0,17,16,1
6173,PENNSYLVANIA,East Coventry Township,6828.0,8,7,1
6174,PENNSYLVANIA,East Earl Township,6938.0,6,6,0
6175,PENNSYLVANIA,Eastern Adams Regional,7399.0,6,6,0
6176,PENNSYLVANIA,East Fallowfield Township,7609.0,7,7,0
6177,PENNSYLVANIA,East Hempfield Township,24835.0,38,34,4
6178,PENNSYLVANIA,East Lampeter Township,17029.0,41,38,3
6179,PENNSYLVANIA,East Lansdowne,2668.0,5,4,1
6180,PENNSYLVANIA,East Marlborough Township,7673.0,2,2,0
6181,PENNSYLVANIA,East McKeesport,2568.0,3,3,0
6182,PENNSYLVANIA,East Pennsboro Township,21595.0,23,22,1
6183,PENNSYLVANIA,East Pikeland Township,7692.0,11,11,0
6184,PENNSYLVANIA,Easttown Township,10623.0,19,18,1
6185,PENNSYLVANIA,East Union Township,1589.0,2,2,0
6186,PENNSYLVANIA,East Vincent Township,7361.0,7,7,0
6187,PENNSYLVANIA,East Whiteland Township,13412.0,25,24,1
6188,PENNSYLVANIA,Ebensburg,2984.0,5,5,0
6189,PENNSYLVANIA,Economy,9024.0,14,13,1
6190,PENNSYLVANIA,Eddystone,2410.0,15,14,1
6191,PENNSYLVANIA,Edgewood,2969.0,9,9,0
6192,PENNSYLVANIA,Edgeworth,1643.0,5,4,1
6193,PENNSYLVANIA,Edinboro,5312.0,8,8,0
6194,PENNSYLVANIA,Edwardsville,4724.0,6,6,0
6195,PENNSYLVANIA,Elizabeth,1965.0,1,1,0
6196,PENNSYLVANIA,Elizabethtown,11491.0,19,17,2
6197,PENNSYLVANIA,Elizabeth Township,12828.0,13,13,0
6198,PENNSYLVANIA,Ellwood City,7168.0,12,11,1
6199,PENNSYLVANIA,Emmaus,11524.0,20,19,1
6200,PENNSYLVANIA,Emporium,1743.0,2,2,0
6201,PENNSYLVANIA,Ephrata,13847.0,36,33,3
6202,PENNSYLVANIA,Erie,94437.0,199,175,24
6203,PENNSYLVANIA,Etna,3269.0,6,6,0
6204,PENNSYLVANIA,Evans City-Seven Fields Regional,4424.0,5,5,0
6205,PENNSYLVANIA,Everett,1706.0,3,3,0
6206,PENNSYLVANIA,Exeter,5510.0,3,3,0
6207,PENNSYLVANIA,"Exeter Township, Berks County",25719.0,36,34,2
6208,PENNSYLVANIA,"Fairview Township, Luzerne County",4511.0,7,7,0
6209,PENNSYLVANIA,"Falls Township, Bucks County",33420.0,60,53,7
6210,PENNSYLVANIA,Fawn Township,2247.0,2,2,0
6211,PENNSYLVANIA,Ferguson Township,19818.0,23,21,2
6212,PENNSYLVANIA,Ferndale,1458.0,1,1,0
6213,PENNSYLVANIA,Findlay Township,6278.0,25,18,7
6214,PENNSYLVANIA,Fleetwood,4095.0,10,9,1
6215,PENNSYLVANIA,Folcroft,6635.0,13,12,1
6216,PENNSYLVANIA,Ford City,2711.0,3,3,0
6217,PENNSYLVANIA,Forest Hills,6228.0,9,9,0
6218,PENNSYLVANIA,Fountain Hill,4722.0,11,10,1
6219,PENNSYLVANIA,Fox Chapel,5042.0,11,11,0
6220,PENNSYLVANIA,Franconia Township,13540.0,11,10,1
6221,PENNSYLVANIA,"Franklin Township, Beaver County",3785.0,4,4,0
6222,PENNSYLVANIA,"Franklin Township, Carbon County",4174.0,5,5,0
6223,PENNSYLVANIA,Frazer Township,1107.0,2,2,0
6224,PENNSYLVANIA,Freedom Township,3299.0,3,3,0
6225,PENNSYLVANIA,Freeland,3402.0,3,3,0
6226,PENNSYLVANIA,Freeport,1648.0,2,2,0
6227,PENNSYLVANIA,Gallitzin,1715.0,2,2,0
6228,PENNSYLVANIA,German Township,4701.0,2,2,0
6229,PENNSYLVANIA,Gettysburg,7720.0,12,11,1
6230,PENNSYLVANIA,Gilpin Township,2358.0,3,3,0
6231,PENNSYLVANIA,Girard,2877.0,4,4,0
6232,PENNSYLVANIA,Glassport,4265.0,11,11,0
6233,PENNSYLVANIA,Glenolden,7099.0,9,8,1
6234,PENNSYLVANIA,Greene County Regional Police Department,3296.0,1,1,0
6235,PENNSYLVANIA,Greenfield Township,1998.0,1,1,0
6236,PENNSYLVANIA,"Greenfield Township, Blair County",3910.0,3,3,0
6237,PENNSYLVANIA,Greensburg,14004.0,32,26,6
6238,PENNSYLVANIA,Green Tree,4791.0,10,10,0
6239,PENNSYLVANIA,Hamburg,4467.0,8,7,1
6240,PENNSYLVANIA,Hampden Township,32134.0,27,25,2
6241,PENNSYLVANIA,Hampton Township,18095.0,21,20,1
6242,PENNSYLVANIA,"Hanover Township, Luzerne County",10798.0,16,16,0
6243,PENNSYLVANIA,Harmar Township,2989.0,8,8,0
6244,PENNSYLVANIA,Harmony Township,2941.0,5,5,0
6245,PENNSYLVANIA,Harrisburg,49303.0,171,130,41
6246,PENNSYLVANIA,Harrison Township,10165.0,14,13,1
6247,PENNSYLVANIA,Harveys Lake,2812.0,5,5,0
6248,PENNSYLVANIA,Hastings,1133.0,2,2,0
6249,PENNSYLVANIA,Hatboro,7526.0,19,16,3
6250,PENNSYLVANIA,Haverford Township,49648.0,76,70,6
6251,PENNSYLVANIA,Hazleton,24750.0,44,43,1
6252,PENNSYLVANIA,Heidelberg,1195.0,4,4,0
6253,PENNSYLVANIA,Hellam Township,8581.0,12,12,0
6254,PENNSYLVANIA,Hemlock Township,2262.0,8,8,0
6255,PENNSYLVANIA,"Hempfield Township, Mercer County",3510.0,8,7,1
6256,PENNSYLVANIA,Highspire,2366.0,5,5,0
6257,PENNSYLVANIA,Hilltown Township,16134.0,19,17,2
6258,PENNSYLVANIA,Hollidaysburg,5620.0,10,8,2
6259,PENNSYLVANIA,Homer City,1573.0,1,1,0
6260,PENNSYLVANIA,Homestead,3127.0,15,14,1
6261,PENNSYLVANIA,Honey Brook,1759.0,1,1,0
6262,PENNSYLVANIA,Hooversville,584.0,1,1,0
6263,PENNSYLVANIA,Hopewell Township,12541.0,17,16,1
6264,PENNSYLVANIA,Horsham Township,26561.0,46,39,7
6265,PENNSYLVANIA,Hughestown,1355.0,2,2,0
6266,PENNSYLVANIA,Hughesville,2015.0,3,3,0
6267,PENNSYLVANIA,Hummelstown,4844.0,8,7,1
6268,PENNSYLVANIA,Huntingdon,6858.0,13,13,0
6269,PENNSYLVANIA,"Independence Township, Beaver County",2295.0,2,2,0
6270,PENNSYLVANIA,Indiana,13041.0,20,19,1
6271,PENNSYLVANIA,Indiana Township,7081.0,10,10,0
6272,PENNSYLVANIA,Ingram,3161.0,4,4,0
6273,PENNSYLVANIA,"Jackson Township, Butler County",4674.0,11,10,1
6274,PENNSYLVANIA,"Jackson Township, Cambria County",3920.0,4,4,0
6275,PENNSYLVANIA,Jefferson Hills Borough,11186.0,21,20,1
6276,PENNSYLVANIA,"Jefferson Township, Mercer County",1780.0,2,2,0
6277,PENNSYLVANIA,Jenkins Township,4578.0,5,5,0
6278,PENNSYLVANIA,Jermyn,2025.0,3,3,0
6279,PENNSYLVANIA,Jessup,4343.0,6,6,0
6280,PENNSYLVANIA,Jim Thorpe,4637.0,9,8,1
6281,PENNSYLVANIA,Johnsonburg,2244.0,3,3,0
6282,PENNSYLVANIA,Johnstown,20112.0,44,40,4
6283,PENNSYLVANIA,Kane,3394.0,4,4,0
6284,PENNSYLVANIA,Kennedy Township,8118.0,12,10,2
6285,PENNSYLVANIA,Kennett Square,6218.0,14,12,2
6286,PENNSYLVANIA,Kennett Township,8914.0,12,11,1
6287,PENNSYLVANIA,Kidder Township,1933.0,8,8,0
6288,PENNSYLVANIA,Kingston,12750.0,21,19,2
6289,PENNSYLVANIA,Kiskiminetas Township,4394.0,3,3,0
6290,PENNSYLVANIA,Kline Township,1350.0,1,1,0
6291,PENNSYLVANIA,Knox,1059.0,2,2,0
6292,PENNSYLVANIA,Kutztown,5078.0,14,12,2
6293,PENNSYLVANIA,Lake City,2817.0,3,3,0
6294,PENNSYLVANIA,Lancaster,58961.0,163,134,29
6295,PENNSYLVANIA,"Lancaster Township, Butler County",2898.0,4,4,0
6296,PENNSYLVANIA,Langhorne Borough,1503.0,1,1,0
6297,PENNSYLVANIA,Lansdowne,10643.0,18,16,2
6298,PENNSYLVANIA,Lansford,3746.0,4,4,0
6299,PENNSYLVANIA,Latrobe,7713.0,15,14,1
6300,PENNSYLVANIA,Laureldale,3897.0,5,5,0
6301,PENNSYLVANIA,Lawrence Park Township,3699.0,8,8,0
6302,PENNSYLVANIA,"Lawrence Township, Clearfield County",7477.0,12,11,1
6303,PENNSYLVANIA,Lebanon,25751.0,41,38,3
6304,PENNSYLVANIA,Leechburg,1952.0,2,2,0
6305,PENNSYLVANIA,Leetsdale,1144.0,5,5,0
6306,PENNSYLVANIA,Leet Township,1569.0,4,4,0
6307,PENNSYLVANIA,Lehighton,5277.0,12,11,1
6308,PENNSYLVANIA,Lehman Township,3432.0,7,7,0
6309,PENNSYLVANIA,Liberty,2427.0,2,2,0
6310,PENNSYLVANIA,"Liberty Township, Adams County",1270.0,1,1,0
6311,PENNSYLVANIA,Limerick Township,19645.0,31,28,3
6312,PENNSYLVANIA,Lincoln,1008.0,3,2,1
6313,PENNSYLVANIA,Linesville,958.0,2,2,0
6314,PENNSYLVANIA,Lititz,10113.0,17,15,2
6315,PENNSYLVANIA,Littlestown,4504.0,9,9,0
6316,PENNSYLVANIA,Lock Haven,8595.0,16,14,2
6317,PENNSYLVANIA,Locust Township,1380.0,5,5,0
6318,PENNSYLVANIA,Logan Township,12106.0,18,16,2
6319,PENNSYLVANIA,Lower Allen Township,20470.0,29,26,3
6320,PENNSYLVANIA,Lower Chichester Township,3479.0,5,5,0
6321,PENNSYLVANIA,Lower Makefield Township,32840.0,41,37,4
6322,PENNSYLVANIA,Lower Moreland Township,13192.0,32,25,7
6323,PENNSYLVANIA,Lower Paxton Township,51097.0,65,57,8
6324,PENNSYLVANIA,Lower Southampton Township,19168.0,35,32,3
6325,PENNSYLVANIA,Lower Swatara Township,9339.0,14,14,0
6326,PENNSYLVANIA,Luzerne,2798.0,4,4,0
6327,PENNSYLVANIA,Lykens,1770.0,1,1,0
6328,PENNSYLVANIA,Macungie,3194.0,4,4,0
6329,PENNSYLVANIA,Mahanoy City,3905.0,5,5,0
6330,PENNSYLVANIA,Mahanoy Township,3120.0,6,6,0
6331,PENNSYLVANIA,"Mahoning Township, Carbon County",4213.0,6,6,0
6332,PENNSYLVANIA,"Mahoning Township, Lawrence County",2820.0,2,2,0
6333,PENNSYLVANIA,Malvern,3506.0,8,7,1
6334,PENNSYLVANIA,Manheim,4812.0,18,17,1
6335,PENNSYLVANIA,Manheim Township,40868.0,75,64,11
6336,PENNSYLVANIA,Manor,3334.0,5,5,0
6337,PENNSYLVANIA,"Manor Township, Armstrong County",3978.0,4,4,0
6338,PENNSYLVANIA,"Manor Township, Lancaster County",21207.0,21,19,2
6339,PENNSYLVANIA,Marcus Hook,2400.0,7,6,1
6340,PENNSYLVANIA,"Marion Township, Beaver County",857.0,2,2,0
6341,PENNSYLVANIA,Marlborough Township,3404.0,4,4,0
6342,PENNSYLVANIA,Marple Township,24015.0,33,30,3
6343,PENNSYLVANIA,Martinsburg,1846.0,3,3,0
6344,PENNSYLVANIA,Masontown,3241.0,4,4,0
6345,PENNSYLVANIA,McCandless,27934.0,31,29,2
6346,PENNSYLVANIA,McKeesport,20551.0,41,39,2
6347,PENNSYLVANIA,McKees Rocks,5789.0,12,11,1
6348,PENNSYLVANIA,McSherrystown,3084.0,5,5,0
6349,PENNSYLVANIA,Meadville,12292.0,24,19,5
6350,PENNSYLVANIA,Mechanicsburg,9025.0,17,15,2
6351,PENNSYLVANIA,Media,5825.0,13,12,1
6352,PENNSYLVANIA,Mercer,1848.0,5,5,0
6353,PENNSYLVANIA,Mercersburg,1525.0,2,2,0
6354,PENNSYLVANIA,Meshoppen,1398.0,2,2,0
6355,PENNSYLVANIA,Meyersdale,2070.0,3,3,0
6356,PENNSYLVANIA,"Middlesex Township, Butler County",6109.0,4,4,0
6357,PENNSYLVANIA,"Middlesex Township, Cumberland County",7637.0,13,12,1
6358,PENNSYLVANIA,Middletown,9694.0,11,11,0
6359,PENNSYLVANIA,Middletown Township,44854.0,66,59,7
6360,PENNSYLVANIA,Midland,2421.0,4,4,0
6361,PENNSYLVANIA,Mifflinburg,3438.0,8,7,1
6362,PENNSYLVANIA,Millbourne,1160.0,1,1,0
6363,PENNSYLVANIA,"Millcreek Township, Erie County",52066.0,78,62,16
6364,PENNSYLVANIA,"Millcreek Township, Lebanon County",5847.0,2,2,0
6365,PENNSYLVANIA,Millersburg,2513.0,3,2,1
6366,PENNSYLVANIA,Millersville,8305.0,15,13,2
6367,PENNSYLVANIA,Millvale,3619.0,7,7,0
6368,PENNSYLVANIA,Milton,6518.0,8,8,0
6369,PENNSYLVANIA,Mohnton,3012.0,3,3,0
6370,PENNSYLVANIA,Monaca,5328.0,9,9,0
6371,PENNSYLVANIA,Monessen,7125.0,14,13,1
6372,PENNSYLVANIA,Monongahela,9720.0,9,8,1
6373,PENNSYLVANIA,Monroeville,27299.0,52,43,9
6374,PENNSYLVANIA,Montoursville,4371.0,7,6,1
6375,PENNSYLVANIA,Montour Township,1278.0,3,3,0
6376,PENNSYLVANIA,Montrose,1449.0,2,2,0
6377,PENNSYLVANIA,Moon Township,25304.0,37,29,8
6378,PENNSYLVANIA,Moosic,5822.0,8,8,0
6379,PENNSYLVANIA,Morrisville,8467.0,9,9,0
6380,PENNSYLVANIA,Morton,2669.0,4,3,1
6381,PENNSYLVANIA,Moscow,2027.0,2,2,0
6382,PENNSYLVANIA,Mount Holly Springs,2055.0,4,4,0
6383,PENNSYLVANIA,Mount Joy,8352.0,13,12,1
6384,PENNSYLVANIA,Mount Lebanon,31284.0,58,45,13
6385,PENNSYLVANIA,Mount Oliver,3242.0,9,9,0
6386,PENNSYLVANIA,Mount Pleasant,4163.0,4,4,0
6387,PENNSYLVANIA,Mount Union,2299.0,5,5,0
6388,PENNSYLVANIA,Muhlenberg Township,20395.0,31,29,2
6389,PENNSYLVANIA,Munhall,10886.0,24,23,1
6390,PENNSYLVANIA,Nanticoke,10260.0,13,12,1
6391,PENNSYLVANIA,Nanty Glo,2411.0,1,1,0
6392,PENNSYLVANIA,Narberth,4298.0,9,6,3
6393,PENNSYLVANIA,Neshannock Township,9122.0,8,8,0
6394,PENNSYLVANIA,Nether Providence Township,13782.0,17,16,1
6395,PENNSYLVANIA,Newberry Township,16053.0,20,18,2
6396,PENNSYLVANIA,New Bethlehem,2677.0,3,3,0
6397,PENNSYLVANIA,New Brighton,8544.0,9,9,0
6398,PENNSYLVANIA,New Britain Township,11582.0,15,14,1
6399,PENNSYLVANIA,New Castle,21303.0,38,35,3
6400,PENNSYLVANIA,New Cumberland,7302.0,9,8,1
6401,PENNSYLVANIA,New Hanover Township,13739.0,11,10,1
6402,PENNSYLVANIA,New Holland,5562.0,14,14,0
6403,PENNSYLVANIA,New Hope,2531.0,9,8,1
6404,PENNSYLVANIA,Newport Township,5325.0,4,4,0
6405,PENNSYLVANIA,New Sewickley Township,7064.0,14,13,1
6406,PENNSYLVANIA,Newtown,2228.0,6,6,0
6407,PENNSYLVANIA,"Newtown Township, Bucks County",22652.0,35,31,4
6408,PENNSYLVANIA,"Newtown Township, Delaware County",14412.0,22,20,2
6409,PENNSYLVANIA,Newville,1353.0,4,4,0
6410,PENNSYLVANIA,New Wilmington,2181.0,5,5,0
6411,PENNSYLVANIA,Norristown,34319.0,80,65,15
6412,PENNSYLVANIA,Northampton Township,38984.0,50,43,7
6413,PENNSYLVANIA,North Braddock,4613.0,2,2,0
6414,PENNSYLVANIA,North Buffalo ,2860.0,1,1,0
6415,PENNSYLVANIA,North Cornwall Township,8016.0,8,7,1
6416,PENNSYLVANIA,North Coventry Township,7931.0,13,12,1
6417,PENNSYLVANIA,"North East, Erie County",3987.0,6,6,0
6418,PENNSYLVANIA,Northern Berks Regional,13529.0,11,11,0
6419,PENNSYLVANIA,Northern Cambria Borough,3421.0,4,4,0
6420,PENNSYLVANIA,Northern Lancaster County Regional,41408.0,33,31,2
6421,PENNSYLVANIA,Northern Regional,36880.0,41,39,2
6422,PENNSYLVANIA,North Fayette Township,15015.0,32,25,7
6423,PENNSYLVANIA,North Lebanon Township,12291.0,15,13,2
6424,PENNSYLVANIA,North Londonderry Township,8673.0,10,9,1
6425,PENNSYLVANIA,North Middleton Township,12128.0,12,11,1
6426,PENNSYLVANIA,North Sewickley Township,5298.0,1,1,0
6427,PENNSYLVANIA,North Versailles Township,11919.0,24,19,5
6428,PENNSYLVANIA,Northwest Lancaster County Regional,20644.0,21,19,2
6429,PENNSYLVANIA,North Woodbury,2548.0,1,1,0
6430,PENNSYLVANIA,Norwood,5957.0,7,6,1
6431,PENNSYLVANIA,Oakmont,6590.0,8,8,0
6432,PENNSYLVANIA,O'Hara Township,8729.0,15,14,1
6433,PENNSYLVANIA,Ohio Township,7171.0,20,18,2
6434,PENNSYLVANIA,Ohioville,3242.0,2,2,0
6435,PENNSYLVANIA,Oil City,9449.0,17,16,1
6436,PENNSYLVANIA,Old Forge,7793.0,7,7,0
6437,PENNSYLVANIA,Old Lycoming Township,4915.0,10,9,1
6438,PENNSYLVANIA,Olyphant,4992.0,7,7,0
6439,PENNSYLVANIA,Orangeville Area,3571.0,1,1,0
6440,PENNSYLVANIA,Orwigsburg,2927.0,6,6,0
6441,PENNSYLVANIA,Oxford,5647.0,12,11,1
6442,PENNSYLVANIA,Palmerton,5311.0,10,9,1
6443,PENNSYLVANIA,Palmer Township,21520.0,37,35,2
6444,PENNSYLVANIA,Palmyra,7549.0,12,11,1
6445,PENNSYLVANIA,Parkesburg,4106.0,8,7,1
6446,PENNSYLVANIA,Parkside,2327.0,1,1,0
6447,PENNSYLVANIA,Parks Township,2517.0,2,2,0
6448,PENNSYLVANIA,Patterson Township,4085.0,4,4,0
6449,PENNSYLVANIA,Patton,1559.0,2,2,0
6450,PENNSYLVANIA,Patton Township,15766.0,22,20,2
6451,PENNSYLVANIA,Penbrook,2974.0,9,9,0
6452,PENNSYLVANIA,Penndel,2184.0,1,1,0
6453,PENNSYLVANIA,Penn Hills,40335.0,53,50,3
6454,PENNSYLVANIA,Pennridge Regional,10913.0,12,11,1
6455,PENNSYLVANIA,"Penn Township, Butler County",4891.0,4,4,0
6456,PENNSYLVANIA,"Penn Township, Westmoreland County",19418.0,23,21,2
6457,PENNSYLVANIA,"Penn Township, York County",16931.0,24,22,2
6458,PENNSYLVANIA,Perkasie,8892.0,20,18,2
6459,PENNSYLVANIA,Perryopolis,1622.0,2,2,0
6460,PENNSYLVANIA,Phoenixville,16954.0,30,29,1
6461,PENNSYLVANIA,Pine Creek Township,3181.0,1,1,0
6462,PENNSYLVANIA,Pine Grove,2042.0,2,2,0
6463,PENNSYLVANIA,Pittsburgh,316632.0,941,907,34
6464,PENNSYLVANIA,Pleasant Hills,7940.0,20,18,2
6465,PENNSYLVANIA,Plum,26979.0,28,26,2
6466,PENNSYLVANIA,Plumstead Township,14701.0,18,16,2
6467,PENNSYLVANIA,Plymouth,5735.0,10,10,0
6468,PENNSYLVANIA,Pocono Mountain Regional,43315.0,47,42,5
6469,PENNSYLVANIA,Point Township,3570.0,6,6,0
6470,PENNSYLVANIA,Polk,763.0,2,2,0
6471,PENNSYLVANIA,Portage,2325.0,2,2,0
6472,PENNSYLVANIA,Port Carbon,1758.0,3,3,0
6473,PENNSYLVANIA,Port Vue,3606.0,3,3,0
6474,PENNSYLVANIA,Prospect Park,6492.0,10,9,1
6475,PENNSYLVANIA,"Pulaski Township, Lawrence County",3196.0,2,2,0
6476,PENNSYLVANIA,Punxsutawney,5638.0,9,8,1
6477,PENNSYLVANIA,Pymatuning Township,2965.0,10,7,3
6478,PENNSYLVANIA,Quakertown,8734.0,23,20,3
6479,PENNSYLVANIA,Quarryville,2759.0,5,5,0
6480,PENNSYLVANIA,Raccoon Township,2848.0,4,4,0
6481,PENNSYLVANIA,Radnor Township,31936.0,49,45,4
6482,PENNSYLVANIA,Ralpho Township,4175.0,6,6,0
6483,PENNSYLVANIA,Rankin,2003.0,1,1,0
6484,PENNSYLVANIA,Reading,88234.0,181,156,25
6485,PENNSYLVANIA,Reading Township,5897.0,2,2,0
6486,PENNSYLVANIA,Redstone Township,4115.0,2,2,0
6487,PENNSYLVANIA,"Richland Township, Bucks County",13375.0,18,16,2
6488,PENNSYLVANIA,"Richland Township, Cambria County",11527.0,23,22,1
6489,PENNSYLVANIA,Ridgway,3674.0,8,7,1
6490,PENNSYLVANIA,Ridley Park,7072.0,10,10,0
6491,PENNSYLVANIA,Ridley Township,31227.0,35,31,4
6492,PENNSYLVANIA,Riverside,1831.0,3,3,0
6493,PENNSYLVANIA,Roaring Brook Township,2003.0,2,2,0
6494,PENNSYLVANIA,Roaring Spring,2383.0,3,3,0
6495,PENNSYLVANIA,Robeson Township,7441.0,6,6,0
6496,PENNSYLVANIA,"Robinson Township, Allegheny County",13927.0,30,29,1
6497,PENNSYLVANIA,Rochester,3382.0,8,7,1
6498,PENNSYLVANIA,Rochester Township,2589.0,4,4,0
6499,PENNSYLVANIA,Ross Township,30289.0,43,42,1
6500,PENNSYLVANIA,Rostraver Township,10916.0,17,16,1
6501,PENNSYLVANIA,Royalton,1031.0,1,1,0
6502,PENNSYLVANIA,Rural Valley,799.0,1,1,0
6503,PENNSYLVANIA,"Sadsbury Township, Chester County",4234.0,4,4,0
6504,PENNSYLVANIA,"Salem Township, Luzerne County",4189.0,8,8,0
6505,PENNSYLVANIA,Salisbury Township,14014.0,22,20,2
6506,PENNSYLVANIA,Sandy Township,10331.0,13,12,1
6507,PENNSYLVANIA,Saxton,674.0,3,3,0
6508,PENNSYLVANIA,Sayre,6311.0,15,13,2
6509,PENNSYLVANIA,"Schuylkill Township, Chester County",8578.0,13,11,2
6510,PENNSYLVANIA,"Scott Township, Allegheny County",16244.0,23,22,1
6511,PENNSYLVANIA,"Scott Township, Columbia County",5030.0,8,8,0
6512,PENNSYLVANIA,"Scott Township, Lackawanna County",4753.0,6,6,0
6513,PENNSYLVANIA,Scranton,76580.0,159,144,15
6514,PENNSYLVANIA,Sewickley Heights,801.0,4,4,0
6515,PENNSYLVANIA,Shaler Township,27412.0,26,26,0
6516,PENNSYLVANIA,Shamokin Dam,1701.0,3,3,0
6517,PENNSYLVANIA,Sharon Hill,5676.0,12,11,1
6518,PENNSYLVANIA,Sharpsburg,3300.0,7,7,0
6519,PENNSYLVANIA,Sharpsville,4006.0,7,7,0
6520,PENNSYLVANIA,Shenandoah,4706.0,5,5,0
6521,PENNSYLVANIA,"Shenango Township, Lawrence County",7042.0,9,9,0
6522,PENNSYLVANIA,Shillington,5301.0,9,8,1
6523,PENNSYLVANIA,Shippensburg,5687.0,10,9,1
6524,PENNSYLVANIA,Shippingport,185.0,2,2,0
6525,PENNSYLVANIA,Shiremanstown,1642.0,2,2,0
6526,PENNSYLVANIA,Silver Spring Township,19326.0,23,22,1
6527,PENNSYLVANIA,Sinking Spring,4106.0,7,6,1
6528,PENNSYLVANIA,Slate Belt Regional,12522.0,20,19,1
6529,PENNSYLVANIA,Slatington,4320.0,7,7,0
6530,PENNSYLVANIA,Slippery Rock,3495.0,4,4,0
6531,PENNSYLVANIA,Solebury Township,8505.0,18,16,2
6532,PENNSYLVANIA,South Abington Township,8701.0,12,11,1
6533,PENNSYLVANIA,South Beaver Township,2611.0,4,4,0
6534,PENNSYLVANIA,South Buffalo Township,2520.0,2,2,0
6535,PENNSYLVANIA,South Coatesville,1519.0,3,3,0
6536,PENNSYLVANIA,Southern Chester County Regional,16500.0,20,18,2
6537,PENNSYLVANIA,South Fayette Township,16098.0,22,21,1
6538,PENNSYLVANIA,South Fork,822.0,1,1,0
6539,PENNSYLVANIA,South Heidelberg Township,12379.0,13,13,0
6540,PENNSYLVANIA,South Lebanon Township,10101.0,9,8,1
6541,PENNSYLVANIA,South Londonderry Township,8689.0,9,9,0
6542,PENNSYLVANIA,South Park Township,13575.0,16,15,1
6543,PENNSYLVANIA,South Pymatuning Township,2473.0,4,4,0
6544,PENNSYLVANIA,South Strabane Township,9461.0,21,20,1
6545,PENNSYLVANIA,"Southwest Regional, Fayette County",2597.0,1,1,0
6546,PENNSYLVANIA,South Whitehall Township,20117.0,42,40,2
6547,PENNSYLVANIA,South Williamsport,6034.0,9,9,0
6548,PENNSYLVANIA,Spring City,3281.0,3,3,0
6549,PENNSYLVANIA,"Springfield Township, Bucks County",5191.0,4,4,0
6550,PENNSYLVANIA,"Springfield Township, Delaware County",24268.0,37,34,3
6551,PENNSYLVANIA,"Springfield Township, Montgomery County",19898.0,30,29,1
6552,PENNSYLVANIA,"Spring Township, Berks County",28173.0,30,29,1
6553,PENNSYLVANIA,"Spring Township, Centre County",8193.0,8,7,1
6554,PENNSYLVANIA,State College,57835.0,67,57,10
6555,PENNSYLVANIA,St. Clair Boro,2805.0,6,6,0
6556,PENNSYLVANIA,Steelton,5954.0,15,13,2
6557,PENNSYLVANIA,St. Marys City,12072.0,16,15,1
6558,PENNSYLVANIA,Stonycreek Township,2525.0,5,5,0
6559,PENNSYLVANIA,Stowe Township,6051.0,10,10,0
6560,PENNSYLVANIA,Strasburg,3035.0,4,4,0
6561,PENNSYLVANIA,Stroud Area Regional,35086.0,51,43,8
6562,PENNSYLVANIA,Sugarcreek,4826.0,3,3,0
6563,PENNSYLVANIA,"Sugarloaf Township, Luzerne County",3866.0,5,5,0
6564,PENNSYLVANIA,Summerhill Township,2211.0,2,2,0
6565,PENNSYLVANIA,Summit Hill,2966.0,5,5,0
6566,PENNSYLVANIA,Sunbury,9268.0,10,9,1
6567,PENNSYLVANIA,"Susquehanna Township, Dauphin County",25280.0,44,40,4
6568,PENNSYLVANIA,Swarthmore,6391.0,8,8,0
6569,PENNSYLVANIA,Sweden Township,810.0,1,1,0
6570,PENNSYLVANIA,Swissvale,8550.0,17,17,0
6571,PENNSYLVANIA,Swoyersville,4998.0,5,5,0
6572,PENNSYLVANIA,Sykesville,1102.0,1,1,0
6573,PENNSYLVANIA,Tarentum,4319.0,10,10,0
6574,PENNSYLVANIA,Tatamy,1212.0,2,2,0
6575,PENNSYLVANIA,Taylor,5842.0,8,8,0
6576,PENNSYLVANIA,Telford,4884.0,7,6,1
6577,PENNSYLVANIA,Throop,3867.0,7,7,0
6578,PENNSYLVANIA,Tilden Township,3618.0,4,4,0
6579,PENNSYLVANIA,"Tinicum Township, Bucks County",3946.0,4,4,0
6580,PENNSYLVANIA,"Tinicum Township, Delaware County",4111.0,18,16,2
6581,PENNSYLVANIA,Titusville,5059.0,11,11,0
6582,PENNSYLVANIA,Trafford,2994.0,6,6,0
6583,PENNSYLVANIA,Trainer,1824.0,16,16,0
6584,PENNSYLVANIA,Tredyffrin Township,29234.0,47,42,5
6585,PENNSYLVANIA,Troy,1221.0,2,2,0
6586,PENNSYLVANIA,Tullytown,2171.0,4,4,0
6587,PENNSYLVANIA,Tulpehocken Township,3534.0,3,3,0
6588,PENNSYLVANIA,Tunkhannock,1660.0,3,3,0
6589,PENNSYLVANIA,"Tunkhannock Township, Wyoming County",5934.0,6,6,0
6590,PENNSYLVANIA,Turtle Creek,5081.0,4,4,0
6591,PENNSYLVANIA,Tyrone,5060.0,6,5,1
6592,PENNSYLVANIA,Union City,3075.0,3,2,1
6593,PENNSYLVANIA,Uniontown,9564.0,21,20,1
6594,PENNSYLVANIA,"Union Township, Lawrence County",4777.0,10,10,0
6595,PENNSYLVANIA,Upland,3348.0,10,9,1
6596,PENNSYLVANIA,Upper Allen Township,20972.0,25,24,1
6597,PENNSYLVANIA,Upper Chichester Township,16979.0,23,22,1
6598,PENNSYLVANIA,Upper Darby Township,82893.0,145,133,12
6599,PENNSYLVANIA,Upper Macungie Township,26421.0,32,29,3
6600,PENNSYLVANIA,Upper Makefield Township,8625.0,19,18,1
6601,PENNSYLVANIA,"Upper Providence Township, Delaware County",10366.0,16,15,1
6602,PENNSYLVANIA,"Upper Providence Township, Montgomery County",24889.0,28,25,3
6603,PENNSYLVANIA,Upper Saucon Township,17725.0,22,20,2
6604,PENNSYLVANIA,Upper Southampton Township,14868.0,25,22,3
6605,PENNSYLVANIA,Upper St. Clair Township,19932.0,34,27,7
6606,PENNSYLVANIA,Upper Uwchlan Township,12072.0,12,12,0
6607,PENNSYLVANIA,Upper Yoder Township,4925.0,6,6,0
6608,PENNSYLVANIA,Uwchlan Township,18807.0,25,23,2
6609,PENNSYLVANIA,Valley Township,7829.0,8,8,0
6610,PENNSYLVANIA,Vernon Township,5299.0,4,4,0
6611,PENNSYLVANIA,Verona,2384.0,4,3,1
6612,PENNSYLVANIA,Versailles,1445.0,2,2,0
6613,PENNSYLVANIA,Warminster Township,32205.0,45,40,5
6614,PENNSYLVANIA,Warrington Township,24747.0,36,35,1
6615,PENNSYLVANIA,"Warwick Township, Bucks County",14759.0,19,18,1
6616,PENNSYLVANIA,"Washington Township, Fayette County",3539.0,5,5,0
6617,PENNSYLVANIA,"Washington Township, Franklin County",15037.0,11,9,2
6618,PENNSYLVANIA,"Washington Township, Northampton County",5299.0,5,5,0
6619,PENNSYLVANIA,"Washington Township, Westmoreland County",6973.0,9,9,0
6620,PENNSYLVANIA,Waverly Township,1668.0,3,3,0
6621,PENNSYLVANIA,Waynesboro,10939.0,19,17,2
6622,PENNSYLVANIA,Waynesburg,3825.0,8,8,0
6623,PENNSYLVANIA,Weatherly,2445.0,5,5,0
6624,PENNSYLVANIA,Wellsboro,3199.0,7,7,0
6625,PENNSYLVANIA,Wesleyville,3069.0,8,7,1
6626,PENNSYLVANIA,West Brandywine Township,7461.0,9,8,1
6627,PENNSYLVANIA,West Caln Township,9079.0,4,4,0
6628,PENNSYLVANIA,West Chester,20214.0,54,43,11
6629,PENNSYLVANIA,West Deer Township,12046.0,15,14,1
6630,PENNSYLVANIA,West Earl Township,8389.0,13,12,1
6631,PENNSYLVANIA,West Fallowfield Township,2596.0,2,2,0
6632,PENNSYLVANIA,Westfield,1022.0,2,2,0
6633,PENNSYLVANIA,West Goshen Township,23089.0,35,32,3
6634,PENNSYLVANIA,West Hempfield Township,16924.0,23,22,1
6635,PENNSYLVANIA,West Hills Regional,9665.0,12,11,1
6636,PENNSYLVANIA,West Homestead,1847.0,11,10,1
6637,PENNSYLVANIA,West Kittanning,1069.0,2,2,0
6638,PENNSYLVANIA,West Lampeter Township,16063.0,18,17,1
6639,PENNSYLVANIA,West Mead Township,4930.0,2,2,0
6640,PENNSYLVANIA,West Mifflin,19517.0,42,36,6
6641,PENNSYLVANIA,West Penn Township,4280.0,1,1,0
6642,PENNSYLVANIA,West Pittston,4730.0,3,3,0
6643,PENNSYLVANIA,West Reading,4295.0,18,15,3
6644,PENNSYLVANIA,West Sadsbury Township,2502.0,5,5,0
6645,PENNSYLVANIA,West Shore Regional,7707.0,13,12,1
6646,PENNSYLVANIA,Westtown-East Goshen Regional,32178.0,32,28,4
6647,PENNSYLVANIA,West View,6441.0,11,10,1
6648,PENNSYLVANIA,West Vincent Township,6181.0,8,7,1
6649,PENNSYLVANIA,West Whiteland Township,20170.0,28,26,2
6650,PENNSYLVANIA,Whitehall,13268.0,24,19,5
6651,PENNSYLVANIA,Whitehall Township,28031.0,52,47,5
6652,PENNSYLVANIA,White Haven Borough,1095.0,2,2,0
6653,PENNSYLVANIA,White Oak,7354.0,13,12,1
6654,PENNSYLVANIA,Wiconisco Township,1202.0,1,1,0
6655,PENNSYLVANIA,Wilkinsburg,15120.0,24,21,3
6656,PENNSYLVANIA,Wilkins Township,6065.0,10,10,0
6657,PENNSYLVANIA,Williamsburg,1159.0,2,2,0
6658,PENNSYLVANIA,Willistown Township,11031.0,21,19,2
6659,PENNSYLVANIA,Woodward Township,2335.0,2,2,0
6660,PENNSYLVANIA,Wyoming,2997.0,3,3,0
6661,PENNSYLVANIA,Wyomissing,10622.0,23,22,1
6662,PENNSYLVANIA,Yardley,2512.0,5,5,0
6663,PENNSYLVANIA,Yeadon,11493.0,17,16,1
6664,PENNSYLVANIA,Zelienople,3605.0,10,9,1
6665,PENNSYLVANIA,Zerbe Township,1736.0,1,1,0
6666,RHODE ISLAND,Barrington,16566.0,29,23,6
6667,RHODE ISLAND,Bristol,22550.0,46,38,8
6668,RHODE ISLAND,Burrillville,17501.0,32,25,7
6669,RHODE ISLAND,Central Falls,20174.0,44,37,7
6670,RHODE ISLAND,Charlestown,8118.0,24,20,4
6671,RHODE ISLAND,Coventry,36216.0,72,57,15
6672,RHODE ISLAND,Cranston,84105.0,179,149,30
6673,RHODE ISLAND,Cumberland,36648.0,56,47,9
6674,RHODE ISLAND,East Greenwich,13617.0,38,31,7
6675,RHODE ISLAND,East Providence,49064.0,110,92,18
6676,RHODE ISLAND,Foster,4933.0,9,6,3
6677,RHODE ISLAND,Glocester,10788.0,22,16,6
6678,RHODE ISLAND,Hopkinton,8379.0,17,12,5
6679,RHODE ISLAND,Jamestown,5687.0,19,14,5
6680,RHODE ISLAND,Johnston,30476.0,77,64,13
6681,RHODE ISLAND,Lincoln,22823.0,38,30,8
6682,RHODE ISLAND,Little Compton,3584.0,14,10,4
6683,RHODE ISLAND,Middletown,16338.0,41,37,4
6684,RHODE ISLAND,Narragansett,15801.0,53,40,13
6685,RHODE ISLAND,Newport,25240.0,101,77,24
6686,RHODE ISLAND,New Shoreham,1064.0,12,6,6
6687,RHODE ISLAND,North Kingstown,27192.0,59,51,8
6688,RHODE ISLAND,North Providence,33712.0,69,62,7
6689,RHODE ISLAND,North Smithfield,13093.0,32,26,6
6690,RHODE ISLAND,Pawtucket,74342.0,171,140,31
6691,RHODE ISLAND,Portsmouth,17696.0,41,38,3
6692,RHODE ISLAND,Providence,185868.0,533,449,84
6693,RHODE ISLAND,Richmond,8189.0,18,14,4
6694,RHODE ISLAND,Scituate,11148.0,24,17,7
6695,RHODE ISLAND,Smithfield,22676.0,54,41,13
6696,RHODE ISLAND,South Kingstown,31537.0,69,54,15
6697,RHODE ISLAND,Tiverton,16106.0,40,28,12
6698,RHODE ISLAND,Warren,10830.0,29,22,7
6699,RHODE ISLAND,Warwick,83968.0,204,162,42
6700,RHODE ISLAND,Westerly,23088.0,59,45,14
6701,RHODE ISLAND,West Greenwich,6680.0,19,13,6
6702,RHODE ISLAND,West Warwick,29964.0,52,44,8
6703,RHODE ISLAND,Woonsocket,43072.0,115,96,19
6704,SOUTH CAROLINA,Abbeville,4932.0,20,19,1
6705,SOUTH CAROLINA,Aiken,31270.0,140,87,53
6706,SOUTH CAROLINA,Allendale,2773.0,5,5,0
6707,SOUTH CAROLINA,Anderson,27831.0,126,92,34
6708,SOUTH CAROLINA,Bamberg,3120.0,12,10,2
6709,SOUTH CAROLINA,Barnwell,4213.0,15,13,2
6710,SOUTH CAROLINA,Batesburg-Leesville,5405.0,27,23,4
6711,SOUTH CAROLINA,Beaufort,13293.0,50,46,4
6712,SOUTH CAROLINA,Belton,4517.0,14,12,2
6713,SOUTH CAROLINA,Bennettsville,7301.0,35,33,2
6714,SOUTH CAROLINA,Bethune,356.0,1,1,0
6715,SOUTH CAROLINA,Blacksburg,1885.0,8,8,0
6716,SOUTH CAROLINA,Bluffton,30519.0,54,48,6
6717,SOUTH CAROLINA,Bonneau,497.0,2,2,0
6718,SOUTH CAROLINA,Branchville,936.0,3,2,1
6719,SOUTH CAROLINA,Briarcliffe Acres,630.0,1,1,0
6720,SOUTH CAROLINA,Burnettown,2784.0,1,1,0
6721,SOUTH CAROLINA,Calhoun Falls,1873.0,3,3,0
6722,SOUTH CAROLINA,Camden,7335.0,37,34,3
6723,SOUTH CAROLINA,Cayce,14088.0,63,53,10
6724,SOUTH CAROLINA,Central,5478.0,12,11,1
6725,SOUTH CAROLINA,Charleston,141768.0,504,413,91
6726,SOUTH CAROLINA,Chester,5341.0,19,16,3
6727,SOUTH CAROLINA,Chesterfield,1394.0,5,5,0
6728,SOUTH CAROLINA,Clemson,18220.0,41,30,11
6729,SOUTH CAROLINA,Clinton,8288.0,28,25,3
6730,SOUTH CAROLINA,Columbia,132255.0,421,324,97
6731,SOUTH CAROLINA,Conway,27781.0,67,56,11
6732,SOUTH CAROLINA,Darlington,5856.0,29,27,2
6733,SOUTH CAROLINA,Denmark,2847.0,7,6,1
6734,SOUTH CAROLINA,Due West,1195.0,5,5,0
6735,SOUTH CAROLINA,Duncan,3772.0,17,16,1
6736,SOUTH CAROLINA,Easley,21789.0,63,52,11
6737,SOUTH CAROLINA,Edgefield,4831.0,9,9,0
6738,SOUTH CAROLINA,Ehrhardt,471.0,2,1,1
6739,SOUTH CAROLINA,Elgin,1613.0,7,6,1
6740,SOUTH CAROLINA,Elloree,626.0,4,3,1
6741,SOUTH CAROLINA,Florence,38521.0,99,75,24
6742,SOUTH CAROLINA,Folly Beach,2699.0,23,18,5
6743,SOUTH CAROLINA,Forest Acres,10261.0,34,26,8
6744,SOUTH CAROLINA,Fort Lawn,888.0,3,2,1
6745,SOUTH CAROLINA,Fort Mill,26923.0,64,52,12
6746,SOUTH CAROLINA,Fountain Inn,11306.0,36,28,8
6747,SOUTH CAROLINA,Gifford,259.0,3,1,2
6748,SOUTH CAROLINA,Goose Creek,45901.0,106,79,27
6749,SOUTH CAROLINA,Greenville,73653.0,247,205,42
6750,SOUTH CAROLINA,Greenwood,23369.0,61,53,8
6751,SOUTH CAROLINA,Greer,36423.0,84,60,24
6752,SOUTH CAROLINA,Hampton,2459.0,15,14,1
6753,SOUTH CAROLINA,Hanahan,29582.0,33,31,2
6754,SOUTH CAROLINA,Hardeeville,9332.0,28,25,3
6755,SOUTH CAROLINA,Hartsville,7454.0,40,37,3
6756,SOUTH CAROLINA,Holly Hill,1151.0,4,4,0
6757,SOUTH CAROLINA,Honea Path,3881.0,13,12,1
6758,SOUTH CAROLINA,Irmo,12902.0,28,25,3
6759,SOUTH CAROLINA,Isle of Palms,4395.0,24,17,7
6760,SOUTH CAROLINA,Iva,1352.0,10,9,1
6761,SOUTH CAROLINA,Jackson,1825.0,4,3,1
6762,SOUTH CAROLINA,Johnsonville,1470.0,7,6,1
6763,SOUTH CAROLINA,Johnston,2397.0,10,10,0
6764,SOUTH CAROLINA,Jonesville,811.0,3,3,0
6765,SOUTH CAROLINA,Kingstree,2958.0,11,10,1
6766,SOUTH CAROLINA,Lake View,773.0,3,3,0
6767,SOUTH CAROLINA,Landrum,2763.0,14,13,1
6768,SOUTH CAROLINA,Laurens,8835.0,36,31,5
6769,SOUTH CAROLINA,Lexington,23161.0,63,60,3
6770,SOUTH CAROLINA,Liberty,3140.0,16,11,5
6771,SOUTH CAROLINA,Loris,2855.0,14,11,3
6772,SOUTH CAROLINA,Lyman,3850.0,12,12,0
6773,SOUTH CAROLINA,Marion,6136.0,18,15,3
6774,SOUTH CAROLINA,Mauldin,25808.0,56,48,8
6775,SOUTH CAROLINA,McCormick,2279.0,6,6,0
6776,SOUTH CAROLINA,Mullins,4092.0,17,16,1
6777,SOUTH CAROLINA,Myrtle Beach,36543.0,283,207,76
6778,SOUTH CAROLINA,Newberry,10119.0,28,25,3
6779,SOUTH CAROLINA,New Ellenton,2201.0,5,4,1
6780,SOUTH CAROLINA,Ninety Six,2043.0,8,8,0
6781,SOUTH CAROLINA,North,692.0,5,5,0
6782,SOUTH CAROLINA,North Augusta,24435.0,88,65,23
6783,SOUTH CAROLINA,North Charleston,121060.0,166,145,21
6784,SOUTH CAROLINA,North Myrtle Beach,17648.0,115,82,33
6785,SOUTH CAROLINA,Olanta,550.0,2,1,1
6786,SOUTH CAROLINA,Pageland,2529.0,14,10,4
6787,SOUTH CAROLINA,Pamplico,1207.0,3,3,0
6788,SOUTH CAROLINA,Pawleys Island,110.0,4,4,0
6789,SOUTH CAROLINA,Pelion,714.0,3,2,1
6790,SOUTH CAROLINA,Port Royal,14970.0,24,23,1
6791,SOUTH CAROLINA,Quinby,912.0,1,1,0
6792,SOUTH CAROLINA,Ridgeland,3853.0,15,14,1
6793,SOUTH CAROLINA,Ridge Spring,738.0,2,2,0
6794,SOUTH CAROLINA,Ridgeville,1830.0,1,1,0
6795,SOUTH CAROLINA,Rock Hill,77334.0,183,137,46
6796,SOUTH CAROLINA,Salem,154.0,1,1,0
6797,SOUTH CAROLINA,Seneca,8611.0,43,30,13
6798,SOUTH CAROLINA,Simpsonville,26077.0,52,42,10
6799,SOUTH CAROLINA,South Congaree,2504.0,7,6,1
6800,SOUTH CAROLINA,Spartanburg,37375.0,140,117,23
6801,SOUTH CAROLINA,Springdale,2743.0,13,12,1
6802,SOUTH CAROLINA,St. George,2206.0,10,9,1
6803,SOUTH CAROLINA,Sullivans Island,1953.0,11,10,1
6804,SOUTH CAROLINA,Summerville,54438.0,146,119,27
6805,SOUTH CAROLINA,Sumter,39328.0,137,104,33
6806,SOUTH CAROLINA,Surfside Beach,4661.0,23,18,5
6807,SOUTH CAROLINA,Swansea,1000.0,3,3,0
6808,SOUTH CAROLINA,Tega Cay,12178.0,33,25,8
6809,SOUTH CAROLINA,Travelers Rest,8297.0,21,15,6
6810,SOUTH CAROLINA,Trenton,201.0,1,1,0
6811,SOUTH CAROLINA,Union,7458.0,27,25,2
6812,SOUTH CAROLINA,Wagener,850.0,3,3,0
6813,SOUTH CAROLINA,Walhalla,4484.0,13,12,1
6814,SOUTH CAROLINA,Walterboro,5303.0,31,30,1
6815,SOUTH CAROLINA,Ware Shoals,2150.0,7,7,0
6816,SOUTH CAROLINA,Wellford,2813.0,11,9,2
6817,SOUTH CAROLINA,West Columbia,18257.0,56,46,10
6818,SOUTH CAROLINA,West Pelzer,961.0,3,3,0
6819,SOUTH CAROLINA,West Union,337.0,3,3,0
6820,SOUTH CAROLINA,Williston,2890.0,10,9,1
6821,SOUTH CAROLINA,Winnsboro,3091.0,18,17,1
6822,SOUTH CAROLINA,York,8728.0,43,37,6
6823,SOUTH DAKOTA,Aberdeen,28385.0,59,50,9
6824,SOUTH DAKOTA,Alcester,750.0,2,2,0
6825,SOUTH DAKOTA,Belle Fourche,5755.0,13,11,2
6826,SOUTH DAKOTA,Beresford,2046.0,5,5,0
6827,SOUTH DAKOTA,Box Elder,10876.0,16,15,1
6828,SOUTH DAKOTA,Brandon,10297.0,15,14,1
6829,SOUTH DAKOTA,Brookings,25088.0,49,36,13
6830,SOUTH DAKOTA,Burke,586.0,1,1,0
6831,SOUTH DAKOTA,Canton,3635.0,6,6,0
6832,SOUTH DAKOTA,Centerville,868.0,2,2,0
6833,SOUTH DAKOTA,Chamberlain,2344.0,7,7,0
6834,SOUTH DAKOTA,Clark,1072.0,2,2,0
6835,SOUTH DAKOTA,Deadwood,1294.0,21,18,3
6836,SOUTH DAKOTA,Eagle Butte,1417.0,1,1,0
6837,SOUTH DAKOTA,Elk Point,1864.0,5,5,0
6838,SOUTH DAKOTA,Flandreau,2288.0,7,6,1
6839,SOUTH DAKOTA,Freeman,1250.0,2,2,0
6840,SOUTH DAKOTA,Gettysburg,1075.0,2,2,0
6841,SOUTH DAKOTA,Gregory,1246.0,2,2,0
6842,SOUTH DAKOTA,Groton,1477.0,4,4,0
6843,SOUTH DAKOTA,Hot Springs,3479.0,9,7,2
6844,SOUTH DAKOTA,Huron,13504.0,35,25,10
6845,SOUTH DAKOTA,Jefferson,512.0,2,2,0
6846,SOUTH DAKOTA,Kadoka,714.0,1,1,0
6847,SOUTH DAKOTA,Kimball,663.0,1,1,0
6848,SOUTH DAKOTA,Lake Norden,547.0,2,2,0
6849,SOUTH DAKOTA,Lead,2929.0,7,6,1
6850,SOUTH DAKOTA,Lennox,2540.0,5,5,0
6851,SOUTH DAKOTA,Madison,7120.0,14,13,1
6852,SOUTH DAKOTA,Martin,1057.0,3,3,0
6853,SOUTH DAKOTA,Menno,616.0,1,1,0
6854,SOUTH DAKOTA,Milbank,3039.0,7,7,0
6855,SOUTH DAKOTA,Miller,1290.0,4,4,0
6856,SOUTH DAKOTA,Mitchell,15741.0,40,26,14
6857,SOUTH DAKOTA,Mobridge,3364.0,16,8,8
6858,SOUTH DAKOTA,Murdo,456.0,1,1,0
6859,SOUTH DAKOTA,North Sioux City,2997.0,9,8,1
6860,SOUTH DAKOTA,Parkston,1450.0,3,3,0
6861,SOUTH DAKOTA,Philip,751.0,2,2,0
6862,SOUTH DAKOTA,Pierre,13710.0,38,24,14
6863,SOUTH DAKOTA,Platte,1259.0,2,2,0
6864,SOUTH DAKOTA,Rapid City,79910.0,170,132,38
6865,SOUTH DAKOTA,Sioux Falls,191508.0,306,271,35
6866,SOUTH DAKOTA,Sisseton,2360.0,6,6,0
6867,SOUTH DAKOTA,Spearfish,12047.0,30,19,11
6868,SOUTH DAKOTA,Springfield,1909.0,2,2,0
6869,SOUTH DAKOTA,Sturgis,7013.0,20,17,3
6870,SOUTH DAKOTA,Summerset,2793.0,7,7,0
6871,SOUTH DAKOTA,Tea,6739.0,8,8,0
6872,SOUTH DAKOTA,Tripp,611.0,1,1,0
6873,SOUTH DAKOTA,Tyndall,1010.0,2,2,0
6874,SOUTH DAKOTA,Vermillion,11088.0,17,16,1
6875,SOUTH DAKOTA,Viborg,761.0,1,1,0
6876,SOUTH DAKOTA,Wagner,1534.0,3,3,0
6877,SOUTH DAKOTA,Watertown,22383.0,58,40,18
6878,SOUTH DAKOTA,Webster,1675.0,5,5,0
6879,SOUTH DAKOTA,Whitewood,1006.0,5,4,1
6880,SOUTH DAKOTA,Winner,2773.0,11,11,0
6881,SOUTH DAKOTA,Yankton,14669.0,39,30,9
6882,TENNESSEE,Adamsville,2159.0,7,6,1
6883,TENNESSEE,Alamo,2251.0,4,4,0
6884,TENNESSEE,Alcoa,10605.0,57,47,10
6885,TENNESSEE,Alexandria,1025.0,3,3,0
6886,TENNESSEE,Algood,4666.0,14,14,0
6887,TENNESSEE,Ardmore,1218.0,7,4,3
6888,TENNESSEE,Ashland City,4763.0,20,18,2
6889,TENNESSEE,Athens,14166.0,30,29,1
6890,TENNESSEE,Atoka,9859.0,23,22,1
6891,TENNESSEE,Baileyton,459.0,3,3,0
6892,TENNESSEE,Bartlett,59562.0,161,124,37
6893,TENNESSEE,Baxter,1563.0,7,7,0
6894,TENNESSEE,Bean Station,3121.0,7,7,0
6895,TENNESSEE,Belle Meade,2777.0,20,14,6
6896,TENNESSEE,Bells,2431.0,4,4,0
6897,TENNESSEE,Benton,1235.0,7,6,1
6898,TENNESSEE,Berry Hill,488.0,18,14,4
6899,TENNESSEE,Big Sandy,515.0,1,1,0
6900,TENNESSEE,Blaine,1871.0,4,4,0
6901,TENNESSEE,Bluff City,1669.0,8,8,0
6902,TENNESSEE,Bolivar,4798.0,26,24,2
6903,TENNESSEE,Bradford,967.0,5,5,0
6904,TENNESSEE,Brentwood,43490.0,84,67,17
6905,TENNESSEE,Brighton,2933.0,8,8,0
6906,TENNESSEE,Bristol,27182.0,96,76,20
6907,TENNESSEE,Brownsville,9128.0,40,34,6
6908,TENNESSEE,Bruceton,1383.0,5,5,0
6909,TENNESSEE,Burns,1570.0,1,1,0
6910,TENNESSEE,Calhoun,504.0,3,3,0
6911,TENNESSEE,Camden,3624.0,19,14,5
6912,TENNESSEE,Carthage,2335.0,12,8,4
6913,TENNESSEE,Caryville,2103.0,7,6,1
6914,TENNESSEE,Celina,1398.0,6,2,4
6915,TENNESSEE,Centerville,3557.0,17,15,2
6916,TENNESSEE,Chapel Hill,1584.0,7,6,1
6917,TENNESSEE,Charleston,712.0,3,3,0
6918,TENNESSEE,Chattanooga,186222.0,494,420,74
6919,TENNESSEE,Church Hill,6633.0,9,9,0
6920,TENNESSEE,Clarksville,164336.0,378,312,66
6921,TENNESSEE,Cleveland,46440.0,112,100,12
6922,TENNESSEE,Clifton,2651.0,5,5,0
6923,TENNESSEE,Clinton,10157.0,40,32,8
6924,TENNESSEE,Collegedale,11737.0,27,24,3
6925,TENNESSEE,Collierville,52059.0,145,110,35
6926,TENNESSEE,Collinwood,927.0,4,4,0
6927,TENNESSEE,Columbia,42613.0,102,76,26
6928,TENNESSEE,Cookeville,35471.0,93,71,22
6929,TENNESSEE,Coopertown,4647.0,6,5,1
6930,TENNESSEE,Cornersville,1329.0,2,2,0
6931,TENNESSEE,Covington,8791.0,38,35,3
6932,TENNESSEE,Cowan,1662.0,3,3,0
6933,TENNESSEE,Cross Plains,1853.0,1,1,0
6934,TENNESSEE,Crossville,12007.0,45,42,3
6935,TENNESSEE,Cumberland City,310.0,2,2,0
6936,TENNESSEE,Dandridge,3204.0,12,11,1
6937,TENNESSEE,Dayton,7338.0,17,15,2
6938,TENNESSEE,Decatur,1665.0,6,6,0
6939,TENNESSEE,Decaturville,856.0,1,1,0
6940,TENNESSEE,Decherd,2375.0,15,13,2
6941,TENNESSEE,Dickson,15634.0,68,61,7
6942,TENNESSEE,Dover,1596.0,7,6,1
6943,TENNESSEE,Dresden,2890.0,8,7,1
6944,TENNESSEE,Dunlap,5278.0,15,13,2
6945,TENNESSEE,Dyer,2192.0,7,6,1
6946,TENNESSEE,Dyersburg,15981.0,64,57,7
6947,TENNESSEE,Eagleville,824.0,3,3,0
6948,TENNESSEE,East Ridge,21225.0,52,47,5
6949,TENNESSEE,Elizabethton,13406.0,47,43,4
6950,TENNESSEE,Elkton,520.0,2,2,0
6951,TENNESSEE,Englewood,1539.0,6,5,1
6952,TENNESSEE,Erin,1304.0,4,3,1
6953,TENNESSEE,Erwin,5832.0,17,16,1
6954,TENNESSEE,Estill Springs,2042.0,7,7,0
6955,TENNESSEE,Ethridge,487.0,4,3,1
6956,TENNESSEE,Etowah,3530.0,12,11,1
6957,TENNESSEE,Fairview,9794.0,23,23,0
6958,TENNESSEE,Fayetteville,7033.0,26,25,1
6959,TENNESSEE,Franklin,87969.0,141,130,11
6960,TENNESSEE,Friendship,658.0,1,1,0
6961,TENNESSEE,Gainesboro,951.0,4,4,0
6962,TENNESSEE,Gallatin,46031.0,92,79,13
6963,TENNESSEE,Gallaway,646.0,2,2,0
6964,TENNESSEE,Gatlinburg,3759.0,47,44,3
6965,TENNESSEE,Germantown,39217.0,134,106,28
6966,TENNESSEE,Gibson,382.0,3,2,1
6967,TENNESSEE,Gleason,1361.0,5,5,0
6968,TENNESSEE,Goodlettsville,16818.0,52,38,14
6969,TENNESSEE,Gordonsville,1248.0,6,6,0
6970,TENNESSEE,Grand Junction,261.0,4,4,0
6971,TENNESSEE,Graysville,1575.0,3,2,1
6972,TENNESSEE,Greenbrier,6949.0,17,14,3
6973,TENNESSEE,Greeneville,14930.0,58,56,2
6974,TENNESSEE,Greenfield,2058.0,7,6,1
6975,TENNESSEE,Halls,2021.0,10,10,0
6976,TENNESSEE,Harriman,6167.0,21,20,1
6977,TENNESSEE,Henderson,6427.0,17,16,1
6978,TENNESSEE,Hendersonville,60170.0,151,135,16
6979,TENNESSEE,Henry,447.0,2,2,0
6980,TENNESSEE,Hohenwald,3992.0,18,16,2
6981,TENNESSEE,Hollow Rock,677.0,1,1,0
6982,TENNESSEE,Hornbeak,467.0,1,1,0
6983,TENNESSEE,Humboldt,8092.0,32,26,6
6984,TENNESSEE,Huntingdon,3820.0,19,15,4
6985,TENNESSEE,Huntland,839.0,2,2,0
6986,TENNESSEE,Jacksboro,2069.0,7,6,1
6987,TENNESSEE,Jackson,67462.0,242,205,37
6988,TENNESSEE,Jamestown,2149.0,9,9,0
6989,TENNESSEE,Jasper,3419.0,9,9,0
6990,TENNESSEE,Jefferson City,8234.0,29,28,1
6991,TENNESSEE,Jellico,2114.0,6,5,1
6992,TENNESSEE,Johnson City,67515.0,172,148,24
6993,TENNESSEE,Jonesborough,5840.0,23,17,6
6994,TENNESSEE,Kenton,1181.0,4,4,0
6995,TENNESSEE,Kimball,1457.0,9,9,0
6996,TENNESSEE,Kingsport,54229.0,147,109,38
6997,TENNESSEE,Kingston,5956.0,13,13,0
6998,TENNESSEE,Kingston Springs,2712.0,8,7,1
6999,TENNESSEE,Knoxville,191463.0,492,382,110
7000,TENNESSEE,Lafayette,5351.0,25,16,9
7001,TENNESSEE,La Follette,6502.0,32,22,10
7002,TENNESSEE,La Vergne,35954.0,72,63,9
7003,TENNESSEE,Lawrenceburg,11122.0,40,36,4
7004,TENNESSEE,Lebanon,39524.0,135,103,32
7005,TENNESSEE,Lenoir City,9401.0,29,27,2
7006,TENNESSEE,Lewisburg,12712.0,29,28,1
7007,TENNESSEE,Lexington,7888.0,35,29,6
7008,TENNESSEE,Livingston,4135.0,23,18,5
7009,TENNESSEE,Lookout Mountain,1886.0,18,14,4
7010,TENNESSEE,Loretto,1790.0,5,5,0
7011,TENNESSEE,Loudon,6079.0,16,15,1
7012,TENNESSEE,Madisonville,5056.0,33,33,0
7013,TENNESSEE,Manchester,11383.0,38,35,3
7014,TENNESSEE,Martin,10480.0,39,29,10
7015,TENNESSEE,Maryville,30262.0,62,57,5
7016,TENNESSEE,Mason,1530.0,5,5,0
7017,TENNESSEE,Maynardville,2461.0,5,4,1
7018,TENNESSEE,McEwen,1744.0,4,4,0
7019,TENNESSEE,McKenzie,5309.0,19,14,5
7020,TENNESSEE,McMinnville,13790.0,40,37,3
7021,TENNESSEE,Medina,4465.0,10,10,0
7022,TENNESSEE,Memphis,649444.0,2446,2027,419
7023,TENNESSEE,Metropolitan Nashville Police Department,690553.0,1850,1450,400
7024,TENNESSEE,Middleton,621.0,2,2,0
7025,TENNESSEE,Milan,7583.0,33,26,7
7026,TENNESSEE,Millersville,6839.0,16,14,2
7027,TENNESSEE,Millington,10621.0,37,29,8
7028,TENNESSEE,Minor Hill,534.0,2,2,0
7029,TENNESSEE,Monteagle,1236.0,7,7,0
7030,TENNESSEE,Monterey,2895.0,10,9,1
7031,TENNESSEE,Morristown,30413.0,81,76,5
7032,TENNESSEE,Moscow,544.0,7,7,0
7033,TENNESSEE,Mosheim,2355.0,2,2,0
7034,TENNESSEE,Mountain City,2437.0,9,9,0
7035,TENNESSEE,Mount Carmel,5242.0,7,7,0
7036,TENNESSEE,Mount Juliet,40233.0,83,65,18
7037,TENNESSEE,Mount Pleasant,5014.0,20,14,6
7038,TENNESSEE,Munford,6233.0,18,18,0
7039,TENNESSEE,Murfreesboro,155652.0,326,267,59
7040,TENNESSEE,Newbern,3222.0,11,11,0
7041,TENNESSEE,New Johnsonville,1866.0,6,5,1
7042,TENNESSEE,New Market,1385.0,5,4,1
7043,TENNESSEE,Newport,6894.0,30,26,4
7044,TENNESSEE,New Tazewell,2694.0,10,10,0
7045,TENNESSEE,Niota,740.0,4,3,1
7046,TENNESSEE,Nolensville,11866.0,17,16,1
7047,TENNESSEE,Norris,1614.0,6,6,0
7048,TENNESSEE,Oakland,8903.0,19,17,2
7049,TENNESSEE,Oak Ridge,29343.0,82,63,19
7050,TENNESSEE,Obion,1035.0,2,2,0
7051,TENNESSEE,Oliver Springs,3443.0,12,12,0
7052,TENNESSEE,Oneida,3696.0,16,11,5
7053,TENNESSEE,Paris,9934.0,37,26,11
7054,TENNESSEE,Parsons,2264.0,7,7,0
7055,TENNESSEE,Petersburg,579.0,1,1,0
7056,TENNESSEE,Pigeon Forge,6276.0,76,61,15
7057,TENNESSEE,Pikeville,1799.0,4,4,0
7058,TENNESSEE,Piperton,2212.0,5,5,0
7059,TENNESSEE,Pittman Center,552.0,3,3,0
7060,TENNESSEE,Plainview,2191.0,2,2,0
7061,TENNESSEE,Pleasant View,5156.0,7,7,0
7062,TENNESSEE,Portland,13493.0,37,33,4
7063,TENNESSEE,Pulaski,7494.0,25,23,2
7064,TENNESSEE,Puryear,651.0,2,1,1
7065,TENNESSEE,Red Bank,11904.0,26,24,2
7066,TENNESSEE,Red Boiling Springs,1125.0,5,5,0
7067,TENNESSEE,Ridgely,1586.0,3,3,0
7068,TENNESSEE,Ripley,7552.0,28,21,7
7069,TENNESSEE,Rockwood,5449.0,15,14,1
7070,TENNESSEE,Rocky Top,1776.0,7,6,1
7071,TENNESSEE,Rogersville,4356.0,20,14,6
7072,TENNESSEE,Rossville,1056.0,8,8,0
7073,TENNESSEE,Rutherford,1056.0,4,4,0
7074,TENNESSEE,Rutledge,1358.0,3,3,0
7075,TENNESSEE,Savannah,6907.0,23,21,2
7076,TENNESSEE,Scotts Hill,972.0,3,3,0
7077,TENNESSEE,Selmer,4277.0,17,15,2
7078,TENNESSEE,Sevierville,18836.0,81,64,17
7079,TENNESSEE,Sharon,900.0,3,2,1
7080,TENNESSEE,Shelbyville,22534.0,60,44,16
7081,TENNESSEE,Signal Mountain,8678.0,17,15,2
7082,TENNESSEE,Smithville,5027.0,14,13,1
7083,TENNESSEE,Smyrna,54645.0,107,90,17
7084,TENNESSEE,Soddy-Daisy,13799.0,35,28,7
7085,TENNESSEE,Somerville,3262.0,12,11,1
7086,TENNESSEE,South Carthage,1416.0,4,4,0
7087,TENNESSEE,South Fulton,2193.0,4,4,0
7088,TENNESSEE,South Pittsburg,3000.0,9,9,0
7089,TENNESSEE,Sparta,4994.0,16,15,1
7090,TENNESSEE,Spencer,1720.0,2,2,0
7091,TENNESSEE,Spring City,1837.0,10,8,2
7092,TENNESSEE,Springfield,17374.0,38,34,4
7093,TENNESSEE,Spring Hill,48297.0,71,67,4
7094,TENNESSEE,St. Joseph,827.0,1,1,0
7095,TENNESSEE,Surgoinsville,1749.0,1,1,0
7096,TENNESSEE,Sweetwater,5971.0,20,19,1
7097,TENNESSEE,Tazewell,2279.0,9,9,0
7098,TENNESSEE,Tellico Plains,915.0,7,7,0
7099,TENNESSEE,Tiptonville,3939.0,7,7,0
7100,TENNESSEE,Townsend,483.0,5,5,0
7101,TENNESSEE,Tracy City,1398.0,1,1,0
7102,TENNESSEE,Trenton,4133.0,23,17,6
7103,TENNESSEE,Trimble,599.0,1,1,0
7104,TENNESSEE,Troy,1321.0,5,5,0
7105,TENNESSEE,Tullahoma,19913.0,38,31,7
7106,TENNESSEE,Tusculum,2669.0,2,2,0
7107,TENNESSEE,Unicoi,3576.0,4,4,0
7108,TENNESSEE,Union City,10272.0,43,36,7
7109,TENNESSEE,Vonore,1589.0,11,10,1
7110,TENNESSEE,Wartburg,899.0,6,6,0
7111,TENNESSEE,Wartrace,726.0,1,1,0
7112,TENNESSEE,Watertown,1542.0,5,5,0
7113,TENNESSEE,Waverly,4123.0,11,10,1
7114,TENNESSEE,Waynesboro,2365.0,7,7,0
7115,TENNESSEE,Westmoreland,2438.0,10,9,1
7116,TENNESSEE,White Bluff,3741.0,6,6,0
7117,TENNESSEE,White House,13282.0,25,22,3
7118,TENNESSEE,White Pine,2673.0,11,10,1
7119,TENNESSEE,Whiteville,4430.0,7,7,0
7120,TENNESSEE,Whitwell,1718.0,6,5,1
7121,TENNESSEE,Winchester,9151.0,25,23,2
7122,TENNESSEE,Woodbury,3007.0,10,10,0
7123,TEXAS,Abernathy,2678.0,5,5,0
7124,TEXAS,Abilene,125088.0,285,210,75
7125,TEXAS,Addison,16540.0,76,66,10
7126,TEXAS,Alamo,20779.0,43,32,11
7127,TEXAS,Alamo Heights,8848.0,33,21,12
7128,TEXAS,Alba,555.0,2,2,0
7129,TEXAS,Alice,18538.0,45,33,12
7130,TEXAS,Alpine,6037.0,15,9,6
7131,TEXAS,Alvarado,4722.0,18,16,2
7132,TEXAS,Alvin,27448.0,83,53,30
7133,TEXAS,Amarillo,200515.0,405,345,60
7134,TEXAS,Andrews,14699.0,24,19,5
7135,TEXAS,Angleton,19593.0,51,34,17
7136,TEXAS,Anna,18215.0,30,29,1
7137,TEXAS,Anthony,5279.0,19,19,0
7138,TEXAS,Aransas Pass,8531.0,43,29,14
7139,TEXAS,Archer City,1711.0,2,2,0
7140,TEXAS,Arcola,2925.0,9,9,0
7141,TEXAS,Argyle,4781.0,14,13,1
7142,TEXAS,Arlington,402323.0,860,674,186
7143,TEXAS,Arp,1054.0,8,7,1
7144,TEXAS,Athens,12778.0,33,25,8
7145,TEXAS,Atlanta,5402.0,16,10,6
7146,TEXAS,Aubrey,7080.0,22,21,1
7147,TEXAS,Austin,1016721.0,2087,1613,474
7148,TEXAS,Azle,13917.0,39,29,10
7149,TEXAS,Baird,1497.0,3,3,0
7150,TEXAS,Balch Springs,24746.0,47,34,13
7151,TEXAS,Balcones Heights,3174.0,26,18,8
7152,TEXAS,Ballinger,3681.0,10,8,2
7153,TEXAS,Bartonville,1871.0,3,3,0
7154,TEXAS,Bastrop,10020.0,26,22,4
7155,TEXAS,Bay City,17441.0,55,36,19
7156,TEXAS,Baytown,77816.0,212,160,52
7157,TEXAS,Beaumont,115290.0,319,243,76
7158,TEXAS,Bedford,48483.0,116,75,41
7159,TEXAS,Beeville,14160.0,28,19,9
7160,TEXAS,Bellaire,19114.0,56,41,15
7161,TEXAS,Bellmead,10927.0,28,20,8
7162,TEXAS,Bells,1528.0,4,4,0
7163,TEXAS,Bellville,4214.0,12,11,1
7164,TEXAS,Belton,23731.0,56,43,13
7165,TEXAS,Benbrook,23529.0,48,37,11
7166,TEXAS,Bertram,1539.0,7,7,0
7167,TEXAS,Big Sandy,1418.0,5,5,0
7168,TEXAS,Big Spring,28166.0,46,35,11
7169,TEXAS,Blanco,2194.0,11,10,1
7170,TEXAS,Blue Mound,2411.0,12,7,5
7171,TEXAS,Boerne,20209.0,57,39,18
7172,TEXAS,Bogata,1054.0,5,5,0
7173,TEXAS,Bonham,10506.0,28,19,9
7174,TEXAS,Borger,12121.0,27,25,2
7175,TEXAS,Bovina,1744.0,3,3,0
7176,TEXAS,Bowie,5133.0,21,15,6
7177,TEXAS,Boyd,1594.0,7,6,1
7178,TEXAS,Brady,5147.0,14,13,1
7179,TEXAS,Brazoria,3066.0,11,8,3
7180,TEXAS,Breckenridge,5365.0,16,10,6
7181,TEXAS,Bremond,966.0,3,3,0
7182,TEXAS,Brenham,17940.0,41,36,5
7183,TEXAS,Bridge City,7809.0,21,15,6
7184,TEXAS,Bridgeport,6711.0,23,15,8
7185,TEXAS,Brookshire,6248.0,22,17,5
7186,TEXAS,Brownfield,9194.0,25,18,7
7187,TEXAS,Brownsboro,1321.0,4,4,0
7188,TEXAS,Brownsville,184287.0,301,226,75
7189,TEXAS,Brownwood,18105.0,58,36,22
7190,TEXAS,Bruceville-Eddy,1712.0,3,3,0
7191,TEXAS,Bryan,89423.0,173,143,30
7192,TEXAS,Buda,19130.0,27,24,3
7193,TEXAS,Buffalo,1916.0,3,3,0
7194,TEXAS,Bullard,4071.0,14,12,2
7195,TEXAS,Bulverde,5593.0,18,17,1
7196,TEXAS,Burkburnett,11465.0,23,16,7
7197,TEXAS,Burleson,51167.0,94,82,12
7198,TEXAS,Burnet,6598.0,21,18,3
7199,TEXAS,Cactus,3239.0,12,9,3
7200,TEXAS,Caddo Mills,1749.0,9,9,0
7201,TEXAS,Caldwell,4535.0,11,10,1
7202,TEXAS,Calvert,1132.0,4,4,0
7203,TEXAS,Cameron,5399.0,15,11,4
7204,TEXAS,Canyon,16726.0,29,26,3
7205,TEXAS,Carrollton,141694.0,229,174,55
7206,TEXAS,Carthage,6314.0,22,17,5
7207,TEXAS,Castle Hills,4480.0,31,23,8
7208,TEXAS,Castroville,3243.0,10,9,1
7209,TEXAS,Cedar Hill,47764.0,86,70,16
7210,TEXAS,Cedar Park,84131.0,126,90,36
7211,TEXAS,Celina,22521.0,33,30,3
7212,TEXAS,Center,5014.0,25,18,7
7213,TEXAS,Chandler,3271.0,8,8,0
7214,TEXAS,Childress,5880.0,12,11,1
7215,TEXAS,China Grove,1329.0,6,6,0
7216,TEXAS,Cibolo,35139.0,46,41,5
7217,TEXAS,Cisco,3848.0,12,10,2
7218,TEXAS,Cleburne,32248.0,69,52,17
7219,TEXAS,Clifton,3406.0,8,7,1
7220,TEXAS,Clint,1138.0,4,4,0
7221,TEXAS,Clute,11774.0,37,25,12
7222,TEXAS,Cockrell Hill,4048.0,22,16,6
7223,TEXAS,Coffee City,301.0,4,4,0
7224,TEXAS,Coleman,4159.0,6,6,0
7225,TEXAS,College Station,122051.0,201,146,55
7226,TEXAS,Colleyville,27544.0,44,39,5
7227,TEXAS,Collinsville,2023.0,4,4,0
7228,TEXAS,Columbus,3703.0,12,11,1
7229,TEXAS,Comanche,4209.0,13,10,3
7230,TEXAS,Combes,3055.0,7,7,0
7231,TEXAS,Commerce,9878.0,22,17,5
7232,TEXAS,Conroe,99965.0,193,151,42
7233,TEXAS,Converse,29635.0,51,46,5
7234,TEXAS,Coppell,40889.0,61,54,7
7235,TEXAS,Copperas Cove,33613.0,68,52,16
7236,TEXAS,Corinth,22635.0,37,32,5
7237,TEXAS,Corpus Christi,329538.0,594,425,169
7238,TEXAS,Corrigan,1708.0,15,10,5
7239,TEXAS,Corsicana,23808.0,53,39,14
7240,TEXAS,Crandall,4418.0,19,19,0
7241,TEXAS,Crane,3681.0,14,9,5
7242,TEXAS,Crockett,6295.0,14,12,2
7243,TEXAS,Crowley,18146.0,38,26,12
7244,TEXAS,Cuero,8225.0,16,15,1
7245,TEXAS,Cuney,140.0,3,2,1
7246,TEXAS,Daingerfield,2377.0,6,5,1
7247,TEXAS,Dallas,1349185.0,3761,3118,643
7248,TEXAS,Dawson,797.0,1,1,0
7249,TEXAS,Dayton,8767.0,31,19,12
7250,TEXAS,Decatur,7747.0,31,24,7
7251,TEXAS,Deer Park,32998.0,89,60,29
7252,TEXAS,De Leon,2192.0,4,4,0
7253,TEXAS,Denison,26119.0,67,50,17
7254,TEXAS,Denton,150975.0,272,191,81
7255,TEXAS,Denver City,4928.0,15,9,6
7256,TEXAS,DeSoto,52891.0,115,79,36
7257,TEXAS,Devine,4998.0,15,11,4
7258,TEXAS,Diboll,5096.0,16,11,5
7259,TEXAS,Dickinson,21442.0,46,31,15
7260,TEXAS,Dimmitt,3966.0,9,7,2
7261,TEXAS,Donna,16371.0,50,36,14
7262,TEXAS,Double Oak,3124.0,8,8,0
7263,TEXAS,Driscoll,740.0,2,2,0
7264,TEXAS,Dublin,3546.0,10,9,1
7265,TEXAS,Dumas,13503.0,28,23,5
7266,TEXAS,Duncanville,37869.0,66,58,8
7267,TEXAS,Earth,940.0,1,1,0
7268,TEXAS,Eastland,3853.0,13,11,2
7269,TEXAS,Edgewood,1578.0,4,4,0
7270,TEXAS,Edinburg,104604.0,230,171,59
7271,TEXAS,Edna,5787.0,10,8,2
7272,TEXAS,El Campo,11484.0,39,27,12
7273,TEXAS,Electra,2732.0,13,8,5
7274,TEXAS,Elmendorf,2198.0,5,4,1
7275,TEXAS,El Paso,684737.0,1395,1138,257
7276,TEXAS,Elsa,7205.0,24,18,6
7277,TEXAS,Emory,1384.0,6,4,2
7278,TEXAS,Ennis,20893.0,44,35,9
7279,TEXAS,Euless,57963.0,136,88,48
7280,TEXAS,Everman,6136.0,23,17,6
7281,TEXAS,Fair Oaks Ranch,10798.0,24,21,3
7282,TEXAS,Fairview,9595.0,17,17,0
7283,TEXAS,Farmers Branch,54026.0,93,72,21
7284,TEXAS,Farmersville,3754.0,10,8,2
7285,TEXAS,Farwell,1267.0,2,2,0
7286,TEXAS,Fate,18907.0,22,20,2
7287,TEXAS,Ferris,3143.0,16,11,5
7288,TEXAS,Florence,1321.0,4,4,0
7289,TEXAS,Floresville,8339.0,19,18,1
7290,TEXAS,Flower Mound,83367.0,144,104,40
7291,TEXAS,Floydada,2621.0,6,6,0
7292,TEXAS,Forney,31521.0,40,27,13
7293,TEXAS,Fort Stockton,8375.0,29,19,10
7294,TEXAS,Fort Worth,947862.0,2088,1631,457
7295,TEXAS,Franklin,1646.0,5,5,0
7296,TEXAS,Frankston,1150.0,7,7,0
7297,TEXAS,Fredericksburg,11620.0,41,35,6
7298,TEXAS,Freeport,12132.0,46,32,14
7299,TEXAS,Friendswood,40434.0,78,59,19
7300,TEXAS,Friona,3741.0,9,5,4
7301,TEXAS,Frisco,222416.0,309,216,93
7302,TEXAS,Fulshear,17318.0,26,24,2
7303,TEXAS,Gainesville,16967.0,58,43,15
7304,TEXAS,Galena Park,10525.0,16,14,2
7305,TEXAS,Galveston,50321.0,171,141,30
7306,TEXAS,Ganado,2094.0,3,3,0
7307,TEXAS,Garden Ridge,4379.0,12,11,1
7308,TEXAS,Garland,237510.0,472,343,129
7309,TEXAS,Garrison,867.0,1,1,0
7310,TEXAS,Gatesville,12558.0,33,21,12
7311,TEXAS,Georgetown,90629.0,115,84,31
7312,TEXAS,Giddings,5175.0,19,13,6
7313,TEXAS,Gilmer,5217.0,19,15,4
7314,TEXAS,Gladewater,6347.0,22,17,5
7315,TEXAS,Glenn Heights,14610.0,29,22,7
7316,TEXAS,Godley,1809.0,6,6,0
7317,TEXAS,Gonzales,7633.0,26,21,5
7318,TEXAS,Gorman,1028.0,2,2,0
7319,TEXAS,Graham,8536.0,19,17,2
7320,TEXAS,Granbury,11466.0,47,41,6
7321,TEXAS,Grand Prairie,196334.0,440,278,162
7322,TEXAS,Grand Saline,3223.0,11,10,1
7323,TEXAS,Granger,1523.0,3,3,0
7324,TEXAS,Grapeland,1423.0,4,4,0
7325,TEXAS,Grapevine,56795.0,148,92,56
7326,TEXAS,Greenville,29780.0,73,53,20
7327,TEXAS,Groesbeck,4162.0,9,9,0
7328,TEXAS,Groves,15187.0,25,21,4
7329,TEXAS,Gun Barrel City,6377.0,20,16,4
7330,TEXAS,Gunter,1776.0,6,6,0
7331,TEXAS,Hallettsville,2651.0,9,8,1
7332,TEXAS,Hallsville,4496.0,6,6,0
7333,TEXAS,Haltom City,43840.0,80,75,5
7334,TEXAS,Hamilton,3019.0,9,8,1
7335,TEXAS,Hamlin,1984.0,9,5,4
7336,TEXAS,Harker Heights,33752.0,61,45,16
7337,TEXAS,Harlingen,65186.0,180,134,46
7338,TEXAS,Haskell,3194.0,6,5,1
7339,TEXAS,Hawkins,1353.0,4,3,1
7340,TEXAS,Hearne,4331.0,19,13,6
7341,TEXAS,Heath,9996.0,26,25,1
7342,TEXAS,Hedwig Village,2605.0,23,17,6
7343,TEXAS,Helotes,10627.0,31,30,1
7344,TEXAS,Hempstead,9214.0,26,19,7
7345,TEXAS,Henderson,12989.0,45,36,9
7346,TEXAS,Hereford,14288.0,35,27,8
7347,TEXAS,Hewitt,15272.0,41,29,12
7348,TEXAS,Hickory Creek,5193.0,13,13,0
7349,TEXAS,Hico,1443.0,5,5,0
7350,TEXAS,Hidalgo,14488.0,43,33,10
7351,TEXAS,Highland Park,9032.0,75,61,14
7352,TEXAS,Highland Village,17071.0,41,29,12
7353,TEXAS,Hill Country Village,1122.0,15,11,4
7354,TEXAS,Hillsboro,8525.0,32,22,10
7355,TEXAS,Hitchcock,7983.0,18,17,1
7356,TEXAS,Hollywood Park,3351.0,16,15,1
7357,TEXAS,Hondo,9564.0,24,22,2
7358,TEXAS,Honey Grove,1746.0,6,6,0
7359,TEXAS,Hooks,2703.0,7,7,0
7360,TEXAS,Horseshoe Bay,4227.0,25,21,4
7361,TEXAS,Houston,2339252.0,6249,5250,999
7362,TEXAS,Howe,3482.0,7,6,1
7363,TEXAS,Hudson Oaks,3857.0,12,11,1
7364,TEXAS,Hughes Springs,1664.0,5,5,0
7365,TEXAS,Humble,15579.0,77,61,16
7366,TEXAS,Huntington,2076.0,5,5,0
7367,TEXAS,Huntsville,41671.0,71,61,10
7368,TEXAS,Hutchins,6048.0,27,20,7
7369,TEXAS,Hutto,31792.0,48,44,4
7370,TEXAS,Idalou,2314.0,5,5,0
7371,TEXAS,Ingleside,10188.0,34,24,10
7372,TEXAS,Ingram,1881.0,8,7,1
7373,TEXAS,Iowa Colony,5771.0,9,8,1
7374,TEXAS,Iowa Park,6435.0,18,12,6
7375,TEXAS,Irving,241692.0,553,380,173
7376,TEXAS,Italy,1972.0,9,8,1
7377,TEXAS,Itasca,1797.0,6,6,0
7378,TEXAS,Jacinto City,10276.0,27,21,6
7379,TEXAS,Jacksboro,4443.0,8,7,1
7380,TEXAS,Jacksonville,14855.0,45,31,14
7381,TEXAS,Jamaica Beach,1085.0,7,7,0
7382,TEXAS,Jarrell,2228.0,9,8,1
7383,TEXAS,Jasper,7600.0,28,21,7
7384,TEXAS,Jefferson,1909.0,4,3,1
7385,TEXAS,Jersey Village,7782.0,27,24,3
7386,TEXAS,Jonestown,2207.0,12,11,1
7387,TEXAS,Joshua,8411.0,17,16,1
7388,TEXAS,Jourdanton,4495.0,7,6,1
7389,TEXAS,Junction,2421.0,9,7,2
7390,TEXAS,Karnes City,3441.0,8,7,1
7391,TEXAS,Katy,25183.0,110,91,19
7392,TEXAS,Kaufman,8804.0,19,16,3
7393,TEXAS,Keene,6637.0,13,12,1
7394,TEXAS,Keller,47721.0,84,47,37
7395,TEXAS,Kemah,2076.0,28,21,7
7396,TEXAS,Kemp,1273.0,5,4,1
7397,TEXAS,Kempner,1167.0,6,5,1
7398,TEXAS,Kenedy,3396.0,15,14,1
7399,TEXAS,Kennedale,8829.0,19,16,3
7400,TEXAS,Kerens,1515.0,4,4,0
7401,TEXAS,Kermit,6441.0,16,11,5
7402,TEXAS,Kerrville,23982.0,67,46,21
7403,TEXAS,Kilgore,15004.0,45,33,12
7404,TEXAS,Killeen,156741.0,284,230,54
7405,TEXAS,Kingsville,24850.0,61,42,19
7406,TEXAS,Kirby,8792.0,16,13,3
7407,TEXAS,Knox City,1119.0,2,2,0
7408,TEXAS,Kountze,2106.0,6,5,1
7409,TEXAS,Kyle,54692.0,87,51,36
7410,TEXAS,Lacy-Lakeview,6836.0,22,12,10
7411,TEXAS,La Feria,7243.0,15,12,3
7412,TEXAS,Lago Vista,8158.0,20,15,5
7413,TEXAS,La Grange,4684.0,12,11,1
7414,TEXAS,La Grulla,1688.0,8,6,2
7415,TEXAS,Laguna Vista,3223.0,8,8,0
7416,TEXAS,Lake Dallas,8230.0,14,11,3
7417,TEXAS,Lake Jackson,27088.0,65,48,17
7418,TEXAS,Lakeport,999.0,3,3,0
7419,TEXAS,Lakeside,1594.0,7,7,0
7420,TEXAS,"Lakeview, Harrison County",6214.0,14,13,1
7421,TEXAS,Lakeway,16747.0,51,35,16
7422,TEXAS,Lake Worth,4886.0,38,29,9
7423,TEXAS,La Marque,17984.0,43,35,8
7424,TEXAS,Lampasas,8269.0,32,21,11
7425,TEXAS,Lancaster,39235.0,61,56,5
7426,TEXAS,La Porte,35972.0,110,80,30
7427,TEXAS,Laredo,266489.0,602,510,92
7428,TEXAS,La Villa,2989.0,8,8,0
7429,TEXAS,Lavon,4235.0,13,13,0
7430,TEXAS,League City,111279.0,170,125,45
7431,TEXAS,Leander,77457.0,89,66,23
7432,TEXAS,Leonard,2077.0,5,5,0
7433,TEXAS,Leon Valley,12431.0,38,36,2
7434,TEXAS,Levelland,13495.0,33,24,9
7435,TEXAS,Lewisville,113998.0,247,171,76
7436,TEXAS,Liberty,9621.0,29,18,11
7437,TEXAS,Liberty Hill,4076.0,16,15,1
7438,TEXAS,Lindale,6956.0,25,18,7
7439,TEXAS,Linden,1880.0,6,5,1
7440,TEXAS,Little Elm,61181.0,86,79,7
7441,TEXAS,Littlefield,5696.0,20,13,7
7442,TEXAS,Live Oak,17051.0,46,34,12
7443,TEXAS,Livingston,5533.0,30,22,8
7444,TEXAS,Llano,3535.0,10,9,1
7445,TEXAS,Lockhart,14209.0,37,26,11
7446,TEXAS,Lockney,1600.0,4,3,1
7447,TEXAS,Log Cabin,792.0,4,4,0
7448,TEXAS,Lone Star,1463.0,3,3,0
7449,TEXAS,Longview,81846.0,207,162,45
7450,TEXAS,Lorena,1762.0,8,7,1
7451,TEXAS,Los Fresnos,7908.0,25,25,0
7452,TEXAS,Lubbock,265990.0,535,421,114
7453,TEXAS,Lufkin,34934.0,86,69,17
7454,TEXAS,Luling,5874.0,20,11,9
7455,TEXAS,Lumberton,13528.0,21,18,3
7456,TEXAS,Lytle,3122.0,9,8,1
7457,TEXAS,Madisonville,4819.0,15,11,4
7458,TEXAS,Magnolia,2331.0,17,14,3
7459,TEXAS,Manor,17725.0,33,28,5
7460,TEXAS,Mansfield,74925.0,156,99,57
7461,TEXAS,Manvel,15262.0,30,22,8
7462,TEXAS,Marble Falls,7231.0,39,25,14
7463,TEXAS,Marfa,1555.0,4,4,0
7464,TEXAS,Marion,1305.0,3,3,0
7465,TEXAS,Marlin,5510.0,14,10,4
7466,TEXAS,Marshall,22425.0,65,50,15
7467,TEXAS,Maud,1062.0,1,1,0
7468,TEXAS,Maypearl,1060.0,4,4,0
7469,TEXAS,McAllen,144973.0,418,275,143
7470,TEXAS,McKinney,217841.0,295,225,70
7471,TEXAS,Meadows Place,4806.0,18,17,1
7472,TEXAS,Melissa,15322.0,16,16,0
7473,TEXAS,Memorial Villages,12243.0,43,30,13
7474,TEXAS,Memphis,1969.0,2,2,0
7475,TEXAS,Mercedes,16684.0,44,38,6
7476,TEXAS,Meridian,1501.0,3,3,0
7477,TEXAS,Merkel,2633.0,4,4,0
7478,TEXAS,Mesquite,137796.0,313,232,81
7479,TEXAS,Mexia,7269.0,16,14,2
7480,TEXAS,Midland,151243.0,251,164,87
7481,TEXAS,Midlothian,36655.0,102,68,34
7482,TEXAS,Miles,898.0,2,2,0
7483,TEXAS,Mineola,4998.0,23,15,8
7484,TEXAS,Mineral Wells,15079.0,45,32,13
7485,TEXAS,Mission,85163.0,205,164,41
7486,TEXAS,Missouri City,77682.0,127,100,27
7487,TEXAS,Monahans,7959.0,21,14,7
7488,TEXAS,Mont Belvieu,7567.0,23,15,8
7489,TEXAS,Montgomery,1812.0,15,14,1
7490,TEXAS,Morgans Point Resort,4844.0,9,9,0
7491,TEXAS,Moulton,905.0,4,4,0
7492,TEXAS,Mount Enterprise,432.0,1,1,0
7493,TEXAS,Mount Pleasant,16023.0,46,33,13
7494,TEXAS,Mount Vernon,2765.0,8,8,0
7495,TEXAS,Muleshoe,4788.0,14,6,8
7496,TEXAS,Murphy,21147.0,29,21,8
7497,TEXAS,Mustang Ridge,1021.0,4,4,0
7498,TEXAS,Nacogdoches,32421.0,84,58,26
7499,TEXAS,Nash,3882.0,7,7,0
7500,TEXAS,Nassau Bay,3897.0,15,14,1
7501,TEXAS,Natalia,1643.0,4,4,0
7502,TEXAS,Navasota,8514.0,27,18,9
7503,TEXAS,Nederland,17205.0,43,28,15
7504,TEXAS,Needville,3150.0,8,8,0
7505,TEXAS,New Boston,4546.0,17,12,5
7506,TEXAS,New Braunfels,100427.0,172,139,33
7507,TEXAS,Newton,2315.0,4,4,0
7508,TEXAS,Nolanville,6335.0,12,11,1
7509,TEXAS,Northeast,3582.0,6,6,0
7510,TEXAS,Northlake,4751.0,23,21,2
7511,TEXAS,North Richland Hills,72881.0,206,112,94
7512,TEXAS,"Oak Ridge, Kaufman County",851.0,27,27,0
7513,TEXAS,Oak Ridge North,3168.0,16,16,0
7514,TEXAS,Odem,2375.0,6,6,0
7515,TEXAS,Odessa,128328.0,192,147,45
7516,TEXAS,Olmos Park,2484.0,14,13,1
7517,TEXAS,Olney,3054.0,10,8,2
7518,TEXAS,Onalaska,3225.0,9,9,0
7519,TEXAS,Orange,17755.0,60,44,16
7520,TEXAS,Overton,2498.0,7,6,1
7521,TEXAS,Ovilla,4370.0,12,11,1
7522,TEXAS,Oyster Creek,1222.0,13,9,4
7523,TEXAS,Palacios,4529.0,13,8,5
7524,TEXAS,Palestine,17736.0,50,33,17
7525,TEXAS,Palmer,2185.0,11,10,1
7526,TEXAS,Palmhurst,2735.0,17,12,5
7527,TEXAS,Pampa,16760.0,30,28,2
7528,TEXAS,Panhandle,2256.0,4,4,0
7529,TEXAS,Pantego,2505.0,18,13,5
7530,TEXAS,Paris,24833.0,68,43,25
7531,TEXAS,Parker,5649.0,11,10,1
7532,TEXAS,Pasadena,149428.0,367,274,93
7533,TEXAS,Patton Village,2277.0,10,10,0
7534,TEXAS,Payne Springs,757.0,2,2,0
7535,TEXAS,Pearland,126983.0,230,169,61
7536,TEXAS,Pearsall,10776.0,19,15,4
7537,TEXAS,Pecos,10675.0,55,24,31
7538,TEXAS,Pelican Bay,2165.0,9,9,0
7539,TEXAS,Penitas,4625.0,16,15,1
7540,TEXAS,Perryton,8272.0,20,11,9
7541,TEXAS,Petersburg,1102.0,4,4,0
7542,TEXAS,Pflugerville,68978.0,127,86,41
7543,TEXAS,Pharr,80436.0,162,132,30
7544,TEXAS,Pilot Point,4741.0,10,10,0
7545,TEXAS,Pinehurst,1946.0,8,6,2
7546,TEXAS,Pineland,789.0,3,3,0
7547,TEXAS,Pittsburg,4696.0,10,8,2
7548,TEXAS,Plainview,19436.0,37,30,7
7549,TEXAS,Plano,294496.0,591,416,175
7550,TEXAS,Pleasanton,11160.0,26,22,4
7551,TEXAS,Ponder,2555.0,7,6,1
7552,TEXAS,Port Aransas,4513.0,29,20,9
7553,TEXAS,Port Arthur,53865.0,151,113,38
7554,TEXAS,Portland,17938.0,50,35,15
7555,TEXAS,Port Lavaca,11618.0,24,18,6
7556,TEXAS,Port Neches,12555.0,25,21,4
7557,TEXAS,Poteet,3571.0,10,9,1
7558,TEXAS,Prairie View ,7174.0,12,11,1
7559,TEXAS,Primera,5394.0,10,9,1
7560,TEXAS,Princeton,17059.0,28,26,2
7561,TEXAS,Prosper,29848.0,51,35,16
7562,TEXAS,Queen City,1409.0,5,5,0
7563,TEXAS,Rancho Viejo,2447.0,8,8,0
7564,TEXAS,Ranger,2343.0,4,4,0
7565,TEXAS,Raymondville,10714.0,21,12,9
7566,TEXAS,Red Oak,14483.0,29,26,3
7567,TEXAS,Refugio,2694.0,8,6,2
7568,TEXAS,"Reno, Lamar County",3366.0,6,5,1
7569,TEXAS,Rice,991.0,4,4,0
7570,TEXAS,Richardson,122872.0,254,164,90
7571,TEXAS,Richland,274.0,3,2,1
7572,TEXAS,Richland Hills,7846.0,22,19,3
7573,TEXAS,Richmond,12520.0,40,29,11
7574,TEXAS,Richwood,4068.0,11,11,0
7575,TEXAS,Rio Grande City,14498.0,44,31,13
7576,TEXAS,Rio Hondo,2669.0,7,7,0
7577,TEXAS,River Oaks,7550.0,23,17,6
7578,TEXAS,Roanoke,10234.0,45,34,11
7579,TEXAS,Robinson,12254.0,32,22,10
7580,TEXAS,Robstown,11114.0,29,20,9
7581,TEXAS,Rockdale,5444.0,17,12,5
7582,TEXAS,Rockport,10934.0,34,27,7
7583,TEXAS,Rockwall,48483.0,102,84,18
7584,TEXAS,Rogers,1255.0,3,3,0
7585,TEXAS,Rollingwood,1589.0,8,7,1
7586,TEXAS,Roma,11534.0,32,24,8
7587,TEXAS,Roman Forest,2086.0,12,11,1
7588,TEXAS,Roscoe,1302.0,2,2,0
7589,TEXAS,Rosenberg,40251.0,97,72,25
7590,TEXAS,Round Rock,141927.0,239,168,71
7591,TEXAS,Rowlett,69287.0,142,93,49
7592,TEXAS,Royse City,16013.0,29,26,3
7593,TEXAS,Runaway Bay,1665.0,5,5,0
7594,TEXAS,Rusk,5674.0,10,9,1
7595,TEXAS,Sachse,26463.0,46,31,15
7596,TEXAS,Saginaw,25387.0,50,38,12
7597,TEXAS,Salado,2401.0,5,5,0
7598,TEXAS,San Angelo,102448.0,204,174,30
7599,TEXAS,San Antonio,1592693.0,2982,2381,601
7600,TEXAS,San Augustine,1842.0,9,8,1
7601,TEXAS,San Benito,24065.0,49,40,9
7602,TEXAS,San Elizario,9041.0,3,3,0
7603,TEXAS,Sanger,9383.0,18,16,2
7604,TEXAS,San Marcos,68961.0,146,106,40
7605,TEXAS,San Saba,3135.0,5,5,0
7606,TEXAS,Sansom Park Village,5826.0,14,8,6
7607,TEXAS,Santa Anna,995.0,4,4,0
7608,TEXAS,Santa Fe,13583.0,30,23,7
7609,TEXAS,Savoy,867.0,2,2,0
7610,TEXAS,Schertz,43637.0,93,62,31
7611,TEXAS,Schulenburg,2944.0,9,8,1
7612,TEXAS,Seabrook,14102.0,39,30,9
7613,TEXAS,Seagoville,17291.0,38,25,13
7614,TEXAS,Sealy,6478.0,28,24,4
7615,TEXAS,Seguin,30653.0,73,52,21
7616,TEXAS,Selma,14299.0,34,30,4
7617,TEXAS,Seminole,8115.0,11,9,2
7618,TEXAS,Seymour,2541.0,4,2,2
7619,TEXAS,Shallowater,2628.0,5,5,0
7620,TEXAS,Shavano Park,4137.0,22,21,1
7621,TEXAS,Shenandoah,3217.0,27,26,1
7622,TEXAS,Sherman,45814.0,99,67,32
7623,TEXAS,Silsbee,6604.0,23,17,6
7624,TEXAS,Sinton,5248.0,13,12,1
7625,TEXAS,Slaton,5960.0,16,10,6
7626,TEXAS,Smithville,4759.0,19,12,7
7627,TEXAS,Snyder,10986.0,20,17,3
7628,TEXAS,Socorro,36282.0,60,44,16
7629,TEXAS,Somerset,2017.0,4,4,0
7630,TEXAS,Somerville,1450.0,3,3,0
7631,TEXAS,Sonora,2744.0,8,6,2
7632,TEXAS,Sour Lake,1962.0,10,8,2
7633,TEXAS,South Houston,17490.0,36,24,12
7634,TEXAS,Southlake,32905.0,68,60,8
7635,TEXAS,South Padre Island,2744.0,36,26,10
7636,TEXAS,Southside Place,1902.0,10,6,4
7637,TEXAS,Spearman,3161.0,4,4,0
7638,TEXAS,Splendora,2371.0,16,14,2
7639,TEXAS,Spring Valley,4363.0,26,20,6
7640,TEXAS,Stafford,17102.0,73,55,18
7641,TEXAS,Stamford,2892.0,7,6,1
7642,TEXAS,Stanton,3114.0,7,6,1
7643,TEXAS,Stephenville,22221.0,55,33,22
7644,TEXAS,Stinnett,1742.0,4,4,0
7645,TEXAS,Sudan,871.0,1,1,0
7646,TEXAS,Sugar Land,118888.0,186,155,31
7647,TEXAS,Sulphur Springs,16357.0,38,28,10
7648,TEXAS,Sunnyvale,7232.0,22,21,1
7649,TEXAS,Sunrise Beach Village,820.0,5,5,0
7650,TEXAS,Sunset Valley,663.0,13,12,1
7651,TEXAS,Surfside Beach,601.0,8,8,0
7652,TEXAS,Sweeny,3612.0,9,8,1
7653,TEXAS,Sweetwater,10497.0,33,24,9
7654,TEXAS,Taft,2871.0,9,7,2
7655,TEXAS,Tahoka,2664.0,4,4,0
7656,TEXAS,Tatum,1417.0,4,4,0
7657,TEXAS,Taylor,18196.0,40,28,12
7658,TEXAS,Teague,3524.0,6,6,0
7659,TEXAS,Temple,82333.0,176,142,34
7660,TEXAS,Tenaha,1132.0,2,2,0
7661,TEXAS,Terrell,20092.0,59,38,21
7662,TEXAS,Terrell Hills,5510.0,16,16,0
7663,TEXAS,Texarkana,36208.0,99,87,12
7664,TEXAS,Texas City,52270.0,112,86,26
7665,TEXAS,Thorndale,1303.0,3,3,0
7666,TEXAS,Tioga,1153.0,4,4,0
7667,TEXAS,Tomball,11826.0,64,46,18
7668,TEXAS,Tom Bean,1076.0,3,3,0
7669,TEXAS,Tool,2346.0,8,4,4
7670,TEXAS,Trophy Club,13205.0,22,18,4
7671,TEXAS,Tulia,4568.0,16,9,7
7672,TEXAS,Tye,1353.0,7,5,2
7673,TEXAS,Tyler,109408.0,236,191,45
7674,TEXAS,Universal City,21265.0,37,27,10
7675,TEXAS,University Park,24888.0,54,38,16
7676,TEXAS,Uvalde,15999.0,56,40,16
7677,TEXAS,Valley Mills,1168.0,4,4,0
7678,TEXAS,Van,2793.0,9,9,0
7679,TEXAS,Van Alstyne,4831.0,19,13,6
7680,TEXAS,Venus,4804.0,14,14,0
7681,TEXAS,Vernon,10057.0,29,20,9
7682,TEXAS,Victoria,67272.0,150,120,30
7683,TEXAS,Vidor,10267.0,33,31,2
7684,TEXAS,Waco,143089.0,349,253,96
7685,TEXAS,Waelder,1164.0,5,4,1
7686,TEXAS,Wake Village,5538.0,9,8,1
7687,TEXAS,Waller,3732.0,13,11,2
7688,TEXAS,Wallis,1334.0,7,7,0
7689,TEXAS,Watauga,24254.0,48,36,12
7690,TEXAS,Waxahachie,40978.0,106,79,27
7691,TEXAS,Weatherford,35724.0,82,58,24
7692,TEXAS,Webster,11359.0,67,48,19
7693,TEXAS,Weimar,2238.0,8,7,1
7694,TEXAS,Weslaco,43954.0,104,79,25
7695,TEXAS,West,2991.0,8,8,0
7696,TEXAS,West Columbia,3823.0,17,11,6
7697,TEXAS,West Lake Hills,3272.0,15,14,1
7698,TEXAS,West Orange,3141.0,12,10,2
7699,TEXAS,West University Place,15590.0,33,24,9
7700,TEXAS,Westworth,2810.0,18,13,5
7701,TEXAS,Wharton,8590.0,32,23,9
7702,TEXAS,Whitehouse,9260.0,15,14,1
7703,TEXAS,White Oak,6262.0,20,16,4
7704,TEXAS,White Settlement,17948.0,41,32,9
7705,TEXAS,Whitewright,1746.0,3,3,0
7706,TEXAS,Whitney,2151.0,6,6,0
7707,TEXAS,Wichita Falls,105468.0,265,197,68
7708,TEXAS,Willis,7258.0,17,15,2
7709,TEXAS,Willow Park,6244.0,19,18,1
7710,TEXAS,Wills Point,3723.0,10,9,1
7711,TEXAS,Wilmer,5620.0,26,21,5
7712,TEXAS,Windcrest,5901.0,39,27,12
7713,TEXAS,Wink,1022.0,2,2,0
7714,TEXAS,Winnsboro,3338.0,16,12,4
7715,TEXAS,Winters,2460.0,7,6,1
7716,TEXAS,Wolfforth,5973.0,14,13,1
7717,TEXAS,Woodsboro,1363.0,1,1,0
7718,TEXAS,Woodville,2428.0,11,10,1
7719,TEXAS,Woodway,9141.0,46,32,14
7720,TEXAS,Wortham,1000.0,4,4,0
7721,TEXAS,Wylie,55889.0,81,64,17
7722,TEXAS,Yoakum,5949.0,16,11,5
7723,TEXAS,Zavalla,712.0,3,3,0
7724,UTAH,Alta,376.0,8,4,4
7725,UTAH,American Fork/Cedar Hills,44725.0,53,47,6
7726,UTAH,Big Water,510.0,1,1,0
7727,UTAH,Blanding,3580.0,6,5,1
7728,UTAH,Bluffdale,19428.0,14,14,0
7729,UTAH,Bountiful,44048.0,57,37,20
7730,UTAH,Brian Head,96.0,15,7,8
7731,UTAH,Brigham City,19901.0,29,24,5
7732,UTAH,Cedar City,36903.0,46,39,7
7733,UTAH,Centerville,17765.0,22,19,3
7734,UTAH,Clearfield,32375.0,45,29,16
7735,UTAH,Clinton,22957.0,22,21,1
7736,UTAH,Cottonwood Heights,33301.0,48,39,9
7737,UTAH,Draper,49671.0,54,44,10
7738,UTAH,East Carbon,1601.0,4,4,0
7739,UTAH,Enoch,7780.0,13,7,6
7740,UTAH,Ephraim,7521.0,9,8,1
7741,UTAH,Fairview,1395.0,1,1,0
7742,UTAH,Farmington,26218.0,25,22,3
7743,UTAH,Fountain Green,1194.0,1,1,0
7744,UTAH,Grantsville,12819.0,19,16,3
7745,UTAH,Harrisville,6983.0,9,8,1
7746,UTAH,Heber,18336.0,26,20,6
7747,UTAH,Helper,2135.0,5,4,1
7748,UTAH,Herriman,61086.0,47,39,8
7749,UTAH,Hildale,2962.0,11,9,2
7750,UTAH,Hurricane,20594.0,28,25,3
7751,UTAH,Kamas,2399.0,2,2,0
7752,UTAH,Kanab,5045.0,9,8,1
7753,UTAH,Kaysville,33139.0,35,32,3
7754,UTAH,La Verkin,4503.0,6,5,1
7755,UTAH,Layton,80230.0,106,71,35
7756,UTAH,Lehi,76545.0,66,61,5
7757,UTAH,Lindon,11609.0,17,15,2
7758,UTAH,Logan,52015.0,83,54,29
7759,UTAH,Lone Peak,30210.0,27,22,5
7760,UTAH,Mapleton,11497.0,10,9,1
7761,UTAH,Moab,5400.0,20,12,8
7762,UTAH,Mount Pleasant,3613.0,5,5,0
7763,UTAH,Murray,48524.0,84,73,11
7764,UTAH,Naples,2150.0,7,7,0
7765,UTAH,Nephi,6598.0,13,11,2
7766,UTAH,North Ogden,21379.0,25,20,5
7767,UTAH,North Park,16742.0,13,10,3
7768,UTAH,North Salt Lake,21768.0,29,24,5
7769,UTAH,Ogden,87828.0,165,125,40
7770,UTAH,Orem,100060.0,134,96,38
7771,UTAH,Park City,8679.0,37,32,5
7772,UTAH,Parowan,3268.0,7,6,1
7773,UTAH,Payson,21291.0,27,24,3
7774,UTAH,Perry,5471.0,8,7,1
7775,UTAH,Pleasant Grove,38730.0,32,28,4
7776,UTAH,Pleasant View,11139.0,14,12,2
7777,UTAH,Price,8399.0,19,16,3
7778,UTAH,Provo,116642.0,127,98,29
7779,UTAH,Richfield,7947.0,17,16,1
7780,UTAH,Riverdale,9038.0,19,17,2
7781,UTAH,Riverton,44951.0,39,35,4
7782,UTAH,Roosevelt,7377.0,15,13,2
7783,UTAH,Roy,39765.0,43,37,6
7784,UTAH,Salem,9151.0,13,12,1
7785,UTAH,Salina,2661.0,6,6,0
7786,UTAH,Salt Lake City,205929.0,627,490,137
7787,UTAH,Sandy,95353.0,143,110,33
7788,UTAH,Santa Clara/Ivins,18948.0,18,14,4
7789,UTAH,Santaquin/Genola,15647.0,15,13,2
7790,UTAH,Saratoga Springs,37985.0,30,26,4
7791,UTAH,Smithfield,12391.0,11,11,0
7792,UTAH,South Jordan,81919.0,66,58,8
7793,UTAH,South Ogden,17187.0,27,22,5
7794,UTAH,South Salt Lake,25422.0,83,70,13
7795,UTAH,Spanish Fork,41931.0,46,41,5
7796,UTAH,Spring City,1111.0,1,1,0
7797,UTAH,Springdale,672.0,9,8,1
7798,UTAH,Springville,33977.0,41,27,14
7799,UTAH,St. George,94601.0,169,120,49
7800,UTAH,Sunset,5354.0,10,8,2
7801,UTAH,Syracuse,33340.0,26,24,2
7802,UTAH,Tooele,37626.0,47,39,8
7803,UTAH,Tremonton Garland,12280.0,17,15,2
7804,UTAH,Vernal,10623.0,21,19,2
7805,UTAH,Washington,33668.0,38,31,7
7806,UTAH,Wellington,1642.0,2,2,0
7807,UTAH,West Bountiful,5988.0,10,9,1
7808,UTAH,West Jordan,117862.0,138,115,23
7809,UTAH,West Valley,134329.0,248,203,45
7810,UTAH,Willard,2022.0,5,4,1
7811,UTAH,Woods Cross,11870.0,18,17,1
7812,VERMONT,Barre,8418.0,19,18,1
7813,VERMONT,Barre Town,7722.0,8,7,1
7814,VERMONT,Bellows Falls,2950.0,7,6,1
7815,VERMONT,Bennington,14814.0,31,24,7
7816,VERMONT,Berlin,2773.0,8,7,1
7817,VERMONT,Bradford,2673.0,2,2,0
7818,VERMONT,Brandon,3680.0,8,7,1
7819,VERMONT,Brattleboro,11182.0,31,18,13
7820,VERMONT,Brighton,1153.0,1,1,0
7821,VERMONT,Bristol,3831.0,3,3,0
7822,VERMONT,Burlington,42946.0,99,69,30
7823,VERMONT,Canaan ,906.0,1,1,0
7824,VERMONT,Castleton,4468.0,5,5,0
7825,VERMONT,Chester,3005.0,6,5,1
7826,VERMONT,Colchester,17101.0,33,25,8
7827,VERMONT,Dover,1051.0,7,6,1
7828,VERMONT,Essex,22073.0,34,28,6
7829,VERMONT,Fair Haven,2511.0,4,4,0
7830,VERMONT,Hardwick,2824.0,7,7,0
7831,VERMONT,Hartford,9530.0,27,17,10
7832,VERMONT,Hinesburg,4535.0,6,6,0
7833,VERMONT,Killington,743.0,2,2,0
7834,VERMONT,Ludlow,1846.0,9,5,4
7835,VERMONT,Lyndonville,1158.0,2,2,0
7836,VERMONT,Manchester,4197.0,10,6,4
7837,VERMONT,Middlebury,8807.0,15,13,2
7838,VERMONT,Milton,10962.0,17,16,1
7839,VERMONT,Montpelier,7278.0,24,15,9
7840,VERMONT,Morristown,5582.0,9,9,0
7841,VERMONT,Newport,4181.0,16,12,4
7842,VERMONT,Northfield,6536.0,6,5,1
7843,VERMONT,Norwich,3400.0,4,3,1
7844,VERMONT,Pittsford,2736.0,1,1,0
7845,VERMONT,Richmond,4102.0,4,4,0
7846,VERMONT,Royalton,2892.0,3,3,0
7847,VERMONT,Rutland,14771.0,39,28,11
7848,VERMONT,Rutland Town,4107.0,4,4,0
7849,VERMONT,Shelburne,7702.0,15,7,8
7850,VERMONT,South Burlington,19748.0,49,35,14
7851,VERMONT,Springfield,8828.0,18,12,6
7852,VERMONT,St. Albans,6787.0,32,21,11
7853,VERMONT,St. Johnsbury,7021.0,16,10,6
7854,VERMONT,Stowe,4460.0,10,10,0
7855,VERMONT,Swanton,6590.0,9,9,0
7856,VERMONT,Thetford,2519.0,3,3,0
7857,VERMONT,Vergennes,2594.0,7,7,0
7858,VERMONT,Weathersfield,2718.0,2,2,0
7859,VERMONT,Williston,10434.0,21,15,6
7860,VERMONT,Wilmington,1777.0,7,5,2
7861,VERMONT,Windsor,3259.0,11,10,1
7862,VERMONT,Winhall,722.0,8,7,1
7863,VERMONT,Winooski,7554.0,15,11,4
7864,VERMONT,Woodstock,2899.0,6,5,1
7865,VIRGINIA,Abingdon,7820.0,28,25,3
7866,VIRGINIA,Alexandria,160457.0,379,295,84
7867,VIRGINIA,Altavista,3419.0,12,11,1
7868,VIRGINIA,Ashland,7976.0,28,25,3
7869,VIRGINIA,Bedford,6652.0,25,21,4
7870,VIRGINIA,Berryville,4388.0,9,8,1
7871,VIRGINIA,Big Stone Gap,5055.0,11,10,1
7872,VIRGINIA,Blacksburg,44228.0,15,12,3
7873,VIRGINIA,Blackstone,3275.0,15,12,3
7874,VIRGINIA,Bluefield,4761.0,23,20,3
7875,VIRGINIA,Bowling Green,1189.0,2,2,0
7876,VIRGINIA,Bridgewater,6218.0,9,9,0
7877,VIRGINIA,Bristol,17265.0,73,54,19
7878,VIRGINIA,Broadway,4026.0,7,6,1
7879,VIRGINIA,Brookneal,1103.0,2,2,0
7880,VIRGINIA,Buena Vista,6374.0,17,16,1
7881,VIRGINIA,Cedar Bluff,986.0,3,3,0
7882,VIRGINIA,Charlottesville,47257.0,133,103,30
7883,VIRGINIA,Chase City,2205.0,10,9,1
7884,VIRGINIA,Chatham,1407.0,3,3,0
7885,VIRGINIA,Chesapeake,249188.0,517,378,139
7886,VIRGINIA,Chilhowie,1687.0,6,6,0
7887,VIRGINIA,Chincoteague,2859.0,14,10,4
7888,VIRGINIA,Christiansburg,22544.0,66,60,6
7889,VIRGINIA,Clarksville,1163.0,8,7,1
7890,VIRGINIA,Clifton Forge,3404.0,8,7,1
7891,VIRGINIA,Clintwood,1247.0,4,4,0
7892,VIRGINIA,Coeburn,1816.0,7,6,1
7893,VIRGINIA,Colonial Beach,3655.0,13,12,1
7894,VIRGINIA,Colonial Heights,17171.0,57,52,5
7895,VIRGINIA,Covington,5603.0,23,17,6
7896,VIRGINIA,Crewe,2096.0,4,3,1
7897,VIRGINIA,Culpeper,19485.0,51,42,9
7898,VIRGINIA,Damascus,772.0,4,4,0
7899,VIRGINIA,Danville,39528.0,135,114,21
7900,VIRGINIA,Dayton,1652.0,5,5,0
7901,VIRGINIA,Dublin,2583.0,8,7,1
7902,VIRGINIA,Dumfries,6233.0,12,11,1
7903,VIRGINIA,Eastville,344.0,6,6,0
7904,VIRGINIA,Elkton,2933.0,6,5,1
7905,VIRGINIA,Emporia,5189.0,37,26,11
7906,VIRGINIA,Exmore,1352.0,7,7,0
7907,VIRGINIA,Fairfax City,23484.0,89,67,22
7908,VIRGINIA,Falls Church,14856.0,56,45,11
7909,VIRGINIA,Farmville,7811.0,28,26,2
7910,VIRGINIA,Franklin,7753.0,33,24,9
7911,VIRGINIA,Fredericksburg,30031.0,93,68,25
7912,VIRGINIA,Front Royal,15499.0,44,33,11
7913,VIRGINIA,Galax,6223.0,26,24,2
7914,VIRGINIA,Gate City,1850.0,5,5,0
7915,VIRGINIA,Glade Spring,1396.0,3,3,0
7916,VIRGINIA,Glasgow,1107.0,1,1,0
7917,VIRGINIA,Gordonsville,1665.0,7,7,0
7918,VIRGINIA,Grottoes,2885.0,6,5,1
7919,VIRGINIA,Grundy,871.0,4,4,0
7920,VIRGINIA,Halifax,1192.0,5,5,0
7921,VIRGINIA,Hampton,135107.0,396,297,99
7922,VIRGINIA,Harrisonburg,53582.0,122,99,23
7923,VIRGINIA,Haymarket,1709.0,6,6,0
7924,VIRGINIA,Haysi,458.0,1,1,0
7925,VIRGINIA,Herndon,24694.0,64,49,15
7926,VIRGINIA,Hillsville,2682.0,12,11,1
7927,VIRGINIA,Honaker,1311.0,2,2,0
7928,VIRGINIA,Hopewell,22322.0,79,58,21
7929,VIRGINIA,Hurt,1203.0,2,2,0
7930,VIRGINIA,Independence,881.0,2,2,0
7931,VIRGINIA,Jonesville,911.0,2,2,0
7932,VIRGINIA,Kenbridge,1189.0,4,4,0
7933,VIRGINIA,Kilmarnock,1392.0,5,5,0
7934,VIRGINIA,La Crosse,574.0,1,1,0
7935,VIRGINIA,Lawrenceville,969.0,6,6,0
7936,VIRGINIA,Lebanon,3158.0,13,12,1
7937,VIRGINIA,Leesburg,55794.0,93,76,17
7938,VIRGINIA,Lexington,7294.0,18,14,4
7939,VIRGINIA,Louisa,1786.0,7,6,1
7940,VIRGINIA,Luray,4844.0,14,13,1
7941,VIRGINIA,Lynchburg,82088.0,184,150,34
7942,VIRGINIA,Manassas,41098.0,119,90,29
7943,VIRGINIA,Manassas Park,18385.0,41,30,11
7944,VIRGINIA,Marion,5515.0,20,19,1
7945,VIRGINIA,Martinsville,12206.0,49,45,4
7946,VIRGINIA,Middleburg,853.0,7,6,1
7947,VIRGINIA,Middletown,1440.0,5,4,1
7948,VIRGINIA,Mount Jackson,2153.0,6,6,0
7949,VIRGINIA,Narrows,1940.0,5,5,0
7950,VIRGINIA,New Market,2276.0,6,6,0
7951,VIRGINIA,Newport News,178662.0,613,437,176
7952,VIRGINIA,Norfolk,242488.0,717,568,149
7953,VIRGINIA,Norton,3978.0,22,14,8
7954,VIRGINIA,Occoquan,1114.0,3,3,0
7955,VIRGINIA,Onancock,1200.0,4,4,0
7956,VIRGINIA,Onley,497.0,4,4,0
7957,VIRGINIA,Orange,5213.0,15,13,2
7958,VIRGINIA,Parksley,801.0,1,1,0
7959,VIRGINIA,Pearisburg,2604.0,8,8,0
7960,VIRGINIA,Pembroke,1073.0,2,2,0
7961,VIRGINIA,Pennington Gap,1692.0,5,5,0
7962,VIRGINIA,Petersburg,30212.0,100,76,24
7963,VIRGINIA,Pocahontas,343.0,1,1,0
7964,VIRGINIA,Poquoson,12253.0,28,27,1
7965,VIRGINIA,Portsmouth,94943.0,219,175,44
7966,VIRGINIA,Pulaski,8615.0,30,26,4
7967,VIRGINIA,Purcellville,10575.0,17,15,2
7968,VIRGINIA,Radford,18427.0,52,37,15
7969,VIRGINIA,Remington,667.0,1,1,0
7970,VIRGINIA,Rich Creek,735.0,1,1,0
7971,VIRGINIA,Richlands,5167.0,21,16,5
7972,VIRGINIA,Richmond,234928.0,727,632,95
7973,VIRGINIA,Roanoke,99175.0,240,199,41
7974,VIRGINIA,Rocky Mount,4707.0,19,17,2
7975,VIRGINIA,Rural Retreat,1445.0,1,1,0
7976,VIRGINIA,Salem,25354.0,86,62,24
7977,VIRGINIA,Shenandoah,2330.0,8,7,1
7978,VIRGINIA,Smithfield,8668.0,6,2,4
7979,VIRGINIA,South Boston,7459.0,28,26,2
7980,VIRGINIA,South Hill,4332.0,23,21,2
7981,VIRGINIA,Stanley,1675.0,5,5,0
7982,VIRGINIA,Staunton,25310.0,61,46,15
7983,VIRGINIA,Stephens City,2136.0,4,4,0
7984,VIRGINIA,St. Paul,837.0,7,7,0
7985,VIRGINIA,Strasburg,6745.0,19,17,2
7986,VIRGINIA,Suffolk,94755.0,213,175,38
7987,VIRGINIA,Tappahannock,2395.0,10,9,1
7988,VIRGINIA,Tazewell,4065.0,16,15,1
7989,VIRGINIA,Victoria,1623.0,4,4,0
7990,VIRGINIA,Vienna,16598.0,49,39,10
7991,VIRGINIA,Vinton,8142.0,23,22,1
7992,VIRGINIA,Virginia Beach,451938.0,964,734,230
7993,VIRGINIA,Warrenton,10019.0,31,29,2
7994,VIRGINIA,Warsaw,1490.0,4,4,0
7995,VIRGINIA,Waynesboro,22896.0,58,47,11
7996,VIRGINIA,West Point,3309.0,12,11,1
7997,VIRGINIA,Williamsburg,15406.0,41,40,1
7998,VIRGINIA,Winchester,27827.0,95,73,22
7999,VIRGINIA,Windsor,2819.0,7,7,0
8000,VIRGINIA,Wintergreen,165.0,15,11,4
8001,VIRGINIA,Wise,2852.0,13,12,1
8002,VIRGINIA,Woodstock,5316.0,19,17,2
8003,VIRGINIA,Wytheville,7847.0,23,21,2
8004,WASHINGTON,Aberdeen,16824.0,52,38,14
8005,WASHINGTON,Airway Heights,10030.0,22,20,2
8006,WASHINGTON,Algona,3216.0,9,8,1
8007,WASHINGTON,Anacortes,17923.0,30,24,6
8008,WASHINGTON,Arlington,21405.0,32,27,5
8009,WASHINGTON,Asotin,1296.0,1,1,0
8010,WASHINGTON,Auburn,82158.0,131,112,19
8011,WASHINGTON,Bainbridge Island,25601.0,25,21,4
8012,WASHINGTON,Battle Ground,22143.0,28,23,5
8013,WASHINGTON,Bellevue,150208.0,212,174,38
8014,WASHINGTON,Bellingham,95279.0,172,115,57
8015,WASHINGTON,Black Diamond,5551.0,11,9,2
8016,WASHINGTON,Blaine,5741.0,13,11,2
8017,WASHINGTON,Bonney Lake,23142.0,37,31,6
8018,WASHINGTON,Bothell,48356.0,93,63,30
8019,WASHINGTON,Bremerton,42798.0,70,54,16
8020,WASHINGTON,Brewster,2393.0,6,5,1
8021,WASHINGTON,Brier,7030.0,3,2,1
8022,WASHINGTON,Buckley,5914.0,13,11,2
8023,WASHINGTON,Burien,51584.0,69,47,22
8024,WASHINGTON,Burlington,9666.0,32,26,6
8025,WASHINGTON,Camas,26683.0,29,27,2
8026,WASHINGTON,Carnation,2366.0,2,2,0
8027,WASHINGTON,Castle Rock,2324.0,6,5,1
8028,WASHINGTON,Centralia,18131.0,32,24,8
8029,WASHINGTON,Chehalis,7885.0,19,15,4
8030,WASHINGTON,Cheney,13175.0,22,16,6
8031,WASHINGTON,Chewelah,2693.0,6,5,1
8032,WASHINGTON,Clarkston,7524.0,16,14,2
8033,WASHINGTON,Cle Elum,3103.0,9,7,2
8034,WASHINGTON,Clyde Hill,3441.0,10,9,1
8035,WASHINGTON,Colfax,2787.0,5,5,0
8036,WASHINGTON,College Place,9560.0,15,12,3
8037,WASHINGTON,Colville,4840.0,11,10,1
8038,WASHINGTON,Connell,5660.0,8,7,1
8039,WASHINGTON,Cosmopolis,1684.0,6,5,1
8040,WASHINGTON,Coulee Dam,1081.0,2,2,0
8041,WASHINGTON,Covington,22024.0,26,20,6
8042,WASHINGTON,Des Moines,32664.0,46,35,11
8043,WASHINGTON,Dupont,9740.0,15,13,2
8044,WASHINGTON,Duvall,8319.0,12,11,1
8045,WASHINGTON,East Wenatchee,14096.0,24,21,3
8046,WASHINGTON,Eatonville,3055.0,6,5,1
8047,WASHINGTON,Edgewood,13909.0,14,13,1
8048,WASHINGTON,Edmonds,42803.0,57,49,8
8049,WASHINGTON,Ellensburg,21933.0,39,29,10
8050,WASHINGTON,Elma,3387.0,10,8,2
8051,WASHINGTON,Enumclaw,12700.0,34,19,15
8052,WASHINGTON,Ephrata,8268.0,18,15,3
8053,WASHINGTON,Everett,113469.0,225,192,33
8054,WASHINGTON,Everson,4624.0,7,6,1
8055,WASHINGTON,Federal Way,97017.0,153,123,30
8056,WASHINGTON,Ferndale,16006.0,25,21,4
8057,WASHINGTON,Fife,10577.0,39,30,9
8058,WASHINGTON,Fircrest,6920.0,9,9,0
8059,WASHINGTON,Forks,3950.0,6,5,1
8060,WASHINGTON,Gig Harbor,11345.0,22,20,2
8061,WASHINGTON,Goldendale,3696.0,11,9,2
8062,WASHINGTON,Grand Coulee,2047.0,8,8,0
8063,WASHINGTON,Grandview,11043.0,22,18,4
8064,WASHINGTON,Granger,3950.0,8,8,0
8065,WASHINGTON,Hoquiam,8696.0,26,23,3
8066,WASHINGTON,Issaquah,40738.0,49,30,19
8067,WASHINGTON,Kalama,2898.0,7,6,1
8068,WASHINGTON,Kelso,12493.0,29,25,4
8069,WASHINGTON,Kenmore,23326.0,18,14,4
8070,WASHINGTON,Kennewick,85595.0,115,100,15
8071,WASHINGTON,Kent,131899.0,194,145,49
8072,WASHINGTON,Kettle Falls,1647.0,5,4,1
8073,WASHINGTON,Kirkland,97027.0,142,105,37
8074,WASHINGTON,Kittitas,1538.0,4,4,0
8075,WASHINGTON,La Center,3674.0,3,3,0
8076,WASHINGTON,Lacey,55484.0,63,49,14
8077,WASHINGTON,Lake Forest Park,13514.0,23,20,3
8078,WASHINGTON,Lake Stevens,35500.0,38,30,8
8079,WASHINGTON,Lakewood,61325.0,109,94,15
8080,WASHINGTON,Langley,1162.0,3,3,0
8081,WASHINGTON,Liberty Lake,11905.0,18,16,2
8082,WASHINGTON,Long Beach,1534.0,9,8,1
8083,WASHINGTON,Longview,38693.0,75,57,18
8084,WASHINGTON,Lynden,15791.0,21,17,4
8085,WASHINGTON,Lynnwood,39370.0,94,62,32
8086,WASHINGTON,Maple Valley,28065.0,27,21,6
8087,WASHINGTON,Marysville,72620.0,98,65,33
8088,WASHINGTON,Mattawa,5182.0,6,6,0
8089,WASHINGTON,McCleary,1849.0,5,5,0
8090,WASHINGTON,Medina,3343.0,11,9,2
8091,WASHINGTON,Mercer Island,26251.0,34,31,3
8092,WASHINGTON,Mill Creek,21076.0,23,20,3
8093,WASHINGTON,Milton,8325.0,12,12,0
8094,WASHINGTON,Monroe,21047.0,41,32,9
8095,WASHINGTON,Montesano,4083.0,9,8,1
8096,WASHINGTON,Morton,1227.0,3,3,0
8097,WASHINGTON,Moses Lake,24694.0,50,42,8
8098,WASHINGTON,Mountlake Terrace,21462.0,37,29,8
8099,WASHINGTON,Mount Vernon,36830.0,53,40,13
8100,WASHINGTON,Moxee,4499.0,8,7,1
8101,WASHINGTON,Mukilteo,21461.0,34,27,7
8102,WASHINGTON,Napavine,2069.0,3,2,1
8103,WASHINGTON,Newcastle,13188.0,15,12,3
8104,WASHINGTON,Newport,2278.0,5,4,1
8105,WASHINGTON,Normandy Park,6587.0,11,10,1
8106,WASHINGTON,Oak Harbor,23792.0,38,28,10
8107,WASHINGTON,Ocean Shores,6851.0,12,11,1
8108,WASHINGTON,Odessa,899.0,1,1,0
8109,WASHINGTON,Olympia,54322.0,111,70,41
8110,WASHINGTON,Omak,4829.0,14,11,3
8111,WASHINGTON,Oroville,1686.0,5,4,1
8112,WASHINGTON,Orting,8866.0,9,8,1
8113,WASHINGTON,Othello,8572.0,24,17,7
8114,WASHINGTON,Pacific,7225.0,10,9,1
8115,WASHINGTON,Palouse,1061.0,2,2,0
8116,WASHINGTON,Pasco,78680.0,92,82,10
8117,WASHINGTON,Port Angeles,20519.0,54,32,22
8118,WASHINGTON,Port Orchard,14995.0,25,21,4
8119,WASHINGTON,Port Townsend,10063.0,12,10,2
8120,WASHINGTON,Poulsbo,11425.0,22,19,3
8121,WASHINGTON,Prosser,6463.0,13,11,2
8122,WASHINGTON,Pullman,34826.0,43,29,14
8123,WASHINGTON,Puyallup,43144.0,92,68,24
8124,WASHINGTON,Quincy,8564.0,29,21,8
8125,WASHINGTON,Raymond,3076.0,8,7,1
8126,WASHINGTON,Reardan,626.0,1,1,0
8127,WASHINGTON,Redmond,74583.0,116,78,38
8128,WASHINGTON,Renton,102458.0,148,114,34
8129,WASHINGTON,Richland,60615.0,73,57,16
8130,WASHINGTON,Ridgefield,12295.0,14,12,2
8131,WASHINGTON,Ritzville,1637.0,3,3,0
8132,WASHINGTON,Roy,828.0,2,2,0
8133,WASHINGTON,Royal City,2697.0,2,2,0
8134,WASHINGTON,Ruston,859.0,4,4,0
8135,WASHINGTON,Sammamish,66855.0,40,32,8
8136,WASHINGTON,SeaTac,29103.0,64,46,18
8137,WASHINGTON,Seattle,787749.0,1597,1178,419
8138,WASHINGTON,Sedro Woolley,12301.0,25,20,5
8139,WASHINGTON,Selah,8220.0,19,16,3
8140,WASHINGTON,Sequim,7911.0,25,19,6
8141,WASHINGTON,Shelton,11073.0,22,19,3
8142,WASHINGTON,Shoreline,58725.0,66,47,19
8143,WASHINGTON,Snohomish,10489.0,19,17,2
8144,WASHINGTON,Snoqualmie,13875.0,24,20,4
8145,WASHINGTON,Soap Lake,1614.0,7,6,1
8146,WASHINGTON,South Bend,1741.0,5,4,1
8147,WASHINGTON,Spokane,223344.0,433,344,89
8148,WASHINGTON,Spokane Valley,104276.0,117,97,20
8149,WASHINGTON,Stanwood,7716.0,13,11,2
8150,WASHINGTON,Steilacoom,6460.0,10,9,1
8151,WASHINGTON,Sumas,1665.0,7,6,1
8152,WASHINGTON,Sumner,10670.0,25,20,5
8153,WASHINGTON,Sunnyside,17021.0,46,28,18
8154,WASHINGTON,Tacoma,222235.0,359,321,38
8155,WASHINGTON,Tenino,1886.0,5,4,1
8156,WASHINGTON,Tieton,1330.0,2,2,0
8157,WASHINGTON,Toledo,792.0,2,1,1
8158,WASHINGTON,Toppenish,8745.0,15,12,3
8159,WASHINGTON,Tukwila,20369.0,86,65,21
8160,WASHINGTON,Tumwater,24727.0,38,31,7
8161,WASHINGTON,Twisp,997.0,3,3,0
8162,WASHINGTON,Union Gap,6163.0,20,17,3
8163,WASHINGTON,University Place,34404.0,17,16,1
8164,WASHINGTON,Vancouver,188160.0,262,214,48
8165,WASHINGTON,Walla Walla,33154.0,77,48,29
8166,WASHINGTON,Wapato,4971.0,9,7,2
8167,WASHINGTON,Warden,2848.0,6,5,1
8168,WASHINGTON,Washougal,16317.0,24,21,3
8169,WASHINGTON,Wenatchee,34349.0,54,43,11
8170,WASHINGTON,Westport,2123.0,8,7,1
8171,WASHINGTON,West Richland,15817.0,23,19,4
8172,WASHINGTON,White Salmon,2764.0,7,6,1
8173,WASHINGTON,Winlock,1504.0,3,3,0
8174,WASHINGTON,Winthrop,502.0,3,3,0
8175,WASHINGTON,Woodinville,15462.0,19,15,4
8176,WASHINGTON,Woodland,6659.0,13,11,2
8177,WASHINGTON,Yakima,94594.0,173,135,38
8178,WASHINGTON,Yelm,9913.0,18,16,2
8179,WASHINGTON,Zillah,3145.0,9,8,1
8180,WEST VIRGINIA,Alderson,1104.0,4,4,0
8181,WEST VIRGINIA,Anmoore,728.0,3,3,0
8182,WEST VIRGINIA,Ansted,1290.0,2,1,1
8183,WEST VIRGINIA,Athens,876.0,1,1,0
8184,WEST VIRGINIA,Barboursville,4258.0,24,22,2
8185,WEST VIRGINIA,Barrackville,1268.0,1,1,0
8186,WEST VIRGINIA,Beckley,15632.0,72,56,16
8187,WEST VIRGINIA,Belington,1896.0,3,3,0
8188,WEST VIRGINIA,Belle,1094.0,2,2,0
8189,WEST VIRGINIA,Benwood,1241.0,11,6,5
8190,WEST VIRGINIA,Berkeley Springs,584.0,3,2,1
8191,WEST VIRGINIA,Bethlehem,2279.0,5,5,0
8192,WEST VIRGINIA,Bluefield,9416.0,33,27,6
8193,WEST VIRGINIA,Bradshaw,251.0,1,1,0
8194,WEST VIRGINIA,Bramwell,331.0,2,2,0
8195,WEST VIRGINIA,Bridgeport,8853.0,40,36,4
8196,WEST VIRGINIA,Buckhannon,5376.0,12,11,1
8197,WEST VIRGINIA,Burnsville,461.0,2,2,0
8198,WEST VIRGINIA,Cameron,818.0,2,2,0
8199,WEST VIRGINIA,Cedar Grove,888.0,1,1,0
8200,WEST VIRGINIA,Ceredo,1233.0,7,4,3
8201,WEST VIRGINIA,Chapmanville,1064.0,5,5,0
8202,WEST VIRGINIA,Charleston,45378.0,180,157,23
8203,WEST VIRGINIA,Charles Town,6098.0,17,14,3
8204,WEST VIRGINIA,Chesapeake,1378.0,1,1,0
8205,WEST VIRGINIA,Chester,2291.0,6,5,1
8206,WEST VIRGINIA,Clarksburg,15290.0,44,40,4
8207,WEST VIRGINIA,Clendenin,1086.0,4,4,0
8208,WEST VIRGINIA,Davy,315.0,1,1,0
8209,WEST VIRGINIA,Delbarton,479.0,2,2,0
8210,WEST VIRGINIA,Dunbar,6868.0,17,16,1
8211,WEST VIRGINIA,East Bank,847.0,1,1,0
8212,WEST VIRGINIA,Eleanor,1585.0,1,1,0
8213,WEST VIRGINIA,Elkins,6881.0,16,14,2
8214,WEST VIRGINIA,Fairmont,18335.0,42,36,6
8215,WEST VIRGINIA,Fairview,402.0,1,1,0
8216,WEST VIRGINIA,Fayetteville,2659.0,11,10,1
8217,WEST VIRGINIA,Follansbee,2640.0,7,7,0
8218,WEST VIRGINIA,Fort Gay,677.0,3,3,0
8219,WEST VIRGINIA,Gary,741.0,1,1,0
8220,WEST VIRGINIA,Gassaway,808.0,1,1,0
8221,WEST VIRGINIA,Gauley Bridge,539.0,1,1,0
8222,WEST VIRGINIA,Gilbert,372.0,3,3,0
8223,WEST VIRGINIA,Glen Dale,1332.0,5,5,0
8224,WEST VIRGINIA,Glenville,1397.0,2,1,1
8225,WEST VIRGINIA,Grafton,4950.0,9,8,1
8226,WEST VIRGINIA,Grant Town,587.0,1,1,0
8227,WEST VIRGINIA,Granville,3727.0,14,14,0
8228,WEST VIRGINIA,Hamlin,995.0,4,3,1
8229,WEST VIRGINIA,Harpers Ferry/Bolivar,1301.0,4,3,1
8230,WEST VIRGINIA,Harrisville,1645.0,1,1,0
8231,WEST VIRGINIA,Hartford City,591.0,2,1,1
8232,WEST VIRGINIA,Hinton,2289.0,4,3,1
8233,WEST VIRGINIA,Huntington,44522.0,98,94,4
8234,WEST VIRGINIA,Hurricane,6401.0,21,19,2
8235,WEST VIRGINIA,Iaeger,226.0,1,1,0
8236,WEST VIRGINIA,Kenova,2914.0,14,10,4
8237,WEST VIRGINIA,Keyser,4811.0,11,10,1
8238,WEST VIRGINIA,Kingwood,3047.0,3,3,0
8239,WEST VIRGINIA,Lewisburg,3759.0,15,13,2
8240,WEST VIRGINIA,Logan,1418.0,11,8,3
8241,WEST VIRGINIA,Lumberport,831.0,2,2,0
8242,WEST VIRGINIA,Mabscott,1236.0,2,2,0
8243,WEST VIRGINIA,Madison,2574.0,7,7,0
8244,WEST VIRGINIA,Man,607.0,2,2,0
8245,WEST VIRGINIA,Mannington,2004.0,4,4,0
8246,WEST VIRGINIA,Marlinton,947.0,1,1,0
8247,WEST VIRGINIA,Marmet,1337.0,5,5,0
8248,WEST VIRGINIA,Martinsburg,17542.0,54,43,11
8249,WEST VIRGINIA,Mason,915.0,6,5,1
8250,WEST VIRGINIA,Masontown,536.0,2,1,1
8251,WEST VIRGINIA,Matewan,407.0,1,1,0
8252,WEST VIRGINIA,McMechen,1644.0,4,4,0
8253,WEST VIRGINIA,Milton,2534.0,11,10,1
8254,WEST VIRGINIA,Monongah,1173.0,1,1,0
8255,WEST VIRGINIA,Montgomery,1478.0,8,6,2
8256,WEST VIRGINIA,Moorefield,2375.0,9,8,1
8257,WEST VIRGINIA,Morgantown,31079.0,83,71,12
8258,WEST VIRGINIA,Moundsville,8036.0,20,16,4
8259,WEST VIRGINIA,Mount Hope,1245.0,5,4,1
8260,WEST VIRGINIA,Mullens,1263.0,3,3,0
8261,WEST VIRGINIA,New Haven,1442.0,2,2,0
8262,WEST VIRGINIA,New Martinsville,5088.0,13,9,4
8263,WEST VIRGINIA,Nitro,6225.0,18,17,1
8264,WEST VIRGINIA,Nutter Fort,1491.0,5,5,0
8265,WEST VIRGINIA,Oak Hill,7948.0,22,18,4
8266,WEST VIRGINIA,Oceana,1177.0,4,4,0
8267,WEST VIRGINIA,Paden City,2266.0,5,4,1
8268,WEST VIRGINIA,Parkersburg,28793.0,79,67,12
8269,WEST VIRGINIA,Parsons,1387.0,1,1,0
8270,WEST VIRGINIA,Pennsboro,1004.0,1,1,0
8271,WEST VIRGINIA,Petersburg,2713.0,3,1,2
8272,WEST VIRGINIA,Philippi,3271.0,6,6,0
8273,WEST VIRGINIA,Piedmont,784.0,1,1,0
8274,WEST VIRGINIA,Pineville,558.0,3,3,0
8275,WEST VIRGINIA,Point Pleasant,3986.0,8,7,1
8276,WEST VIRGINIA,Pratt,547.0,2,1,1
8277,WEST VIRGINIA,Princeton,5551.0,22,20,2
8278,WEST VIRGINIA,Rainelle,1518.0,3,2,1
8279,WEST VIRGINIA,Ranson,5466.0,18,17,1
8280,WEST VIRGINIA,Ravenswood,3594.0,12,10,2
8281,WEST VIRGINIA,Reedsville,605.0,1,1,0
8282,WEST VIRGINIA,Rhodell,158.0,2,1,1
8283,WEST VIRGINIA,Richwood,1822.0,3,3,0
8284,WEST VIRGINIA,Ridgeley,608.0,4,3,1
8285,WEST VIRGINIA,Ripley,3130.0,11,10,1
8286,WEST VIRGINIA,Rivesville,893.0,1,1,0
8287,WEST VIRGINIA,Romney,1665.0,7,6,1
8288,WEST VIRGINIA,Rupert,874.0,1,1,0
8289,WEST VIRGINIA,Salem,1504.0,3,3,0
8290,WEST VIRGINIA,Shepherdstown,1901.0,6,5,1
8291,WEST VIRGINIA,Shinnston,2085.0,10,9,1
8292,WEST VIRGINIA,Sistersville,1259.0,2,2,0
8293,WEST VIRGINIA,Sophia,1208.0,6,6,0
8294,WEST VIRGINIA,South Charleston,11884.0,49,45,4
8295,WEST VIRGINIA,Spencer,1962.0,4,4,0
8296,WEST VIRGINIA,St. Albans,9646.0,27,24,3
8297,WEST VIRGINIA,Star City,2005.0,7,6,1
8298,WEST VIRGINIA,St. Marys,1748.0,5,4,1
8299,WEST VIRGINIA,Stonewood,1692.0,2,2,0
8300,WEST VIRGINIA,Summersville,3194.0,17,16,1
8301,WEST VIRGINIA,Sutton,967.0,1,1,0
8302,WEST VIRGINIA,Sylvester,131.0,1,1,0
8303,WEST VIRGINIA,Terra Alta,1505.0,1,1,0
8304,WEST VIRGINIA,Triadelphia,745.0,1,1,0
8305,WEST VIRGINIA,Vienna,9952.0,23,19,4
8306,WEST VIRGINIA,War,642.0,3,3,0
8307,WEST VIRGINIA,Wayne,1546.0,2,2,0
8308,WEST VIRGINIA,Webster Springs,649.0,4,3,1
8309,WEST VIRGINIA,Weirton,17911.0,42,38,4
8310,WEST VIRGINIA,Welch,1511.0,4,3,1
8311,WEST VIRGINIA,Wellsburg,2468.0,6,6,0
8312,WEST VIRGINIA,West Logan,352.0,1,1,0
8313,WEST VIRGINIA,West Milford,607.0,2,2,0
8314,WEST VIRGINIA,Weston,3770.0,8,6,2
8315,WEST VIRGINIA,Westover,4243.0,14,14,0
8316,WEST VIRGINIA,Wheeling,26081.0,87,71,16
8317,WEST VIRGINIA,White Hall,667.0,5,5,0
8318,WEST VIRGINIA,White Sulphur Springs,2315.0,8,7,1
8319,WEST VIRGINIA,Williamson,2565.0,7,6,1
8320,WEST VIRGINIA,Williamstown,2855.0,8,7,1
8321,WEST VIRGINIA,Winfield,2414.0,7,7,0
8322,WISCONSIN,Adams,1898.0,4,4,0
8323,WISCONSIN,Albany,973.0,3,3,0
8324,WISCONSIN,Algoma,3026.0,10,5,5
8325,WISCONSIN,Altoona,8210.0,16,15,1
8326,WISCONSIN,Amery,2786.0,9,7,2
8327,WISCONSIN,Antigo,7671.0,18,15,3
8328,WISCONSIN,Appleton,74204.0,132,106,26
8329,WISCONSIN,Arcadia,3034.0,4,4,0
8330,WISCONSIN,Ashland,7723.0,21,19,2
8331,WISCONSIN,Ashwaubenon,17008.0,56,51,5
8332,WISCONSIN,Athens,1077.0,1,1,0
8333,WISCONSIN,Baraboo,12127.0,33,29,4
8334,WISCONSIN,Barneveld,1254.0,1,1,0
8335,WISCONSIN,Barron,3215.0,6,6,0
8336,WISCONSIN,Bayfield,473.0,3,3,0
8337,WISCONSIN,Bayside,4353.0,12,12,0
8338,WISCONSIN,Beaver Dam,16314.0,35,31,4
8339,WISCONSIN,Belleville,2528.0,6,5,1
8340,WISCONSIN,Beloit,36603.0,83,71,12
8341,WISCONSIN,Beloit Town,7724.0,14,12,2
8342,WISCONSIN,Berlin,5367.0,13,12,1
8343,WISCONSIN,Big Bend,1511.0,3,3,0
8344,WISCONSIN,Birchwood,424.0,1,1,0
8345,WISCONSIN,Black River Falls,3439.0,7,6,1
8346,WISCONSIN,Blair,1323.0,3,3,0
8347,WISCONSIN,Blanchardville,784.0,3,3,0
8348,WISCONSIN,Bloomer,3504.0,8,7,1
8349,WISCONSIN,Bloomfield,6538.0,8,8,0
8350,WISCONSIN,Blue Mounds,1004.0,2,1,1
8351,WISCONSIN,Boscobel,3126.0,6,6,0
8352,WISCONSIN,Boyceville,1127.0,2,2,0
8353,WISCONSIN,Brillion,3071.0,8,8,0
8354,WISCONSIN,Brodhead,3195.0,11,7,4
8355,WISCONSIN,Brookfield,39292.0,95,80,15
8356,WISCONSIN,Brookfield Township,6561.0,16,15,1
8357,WISCONSIN,Brown Deer,12310.0,31,28,3
8358,WISCONSIN,Brownsville,585.0,1,1,0
8359,WISCONSIN,Burlington,10938.0,23,22,1
8360,WISCONSIN,Butler,1790.0,9,8,1
8361,WISCONSIN,Caledonia,25272.0,39,37,2
8362,WISCONSIN,Campbellsport,1792.0,2,2,0
8363,WISCONSIN,Campbell Township,4273.0,5,5,0
8364,WISCONSIN,Cashton,1112.0,2,2,0
8365,WISCONSIN,Cedarburg,11818.0,29,21,8
8366,WISCONSIN,Chenequa,610.0,8,8,0
8367,WISCONSIN,Chetek,2083.0,5,4,1
8368,WISCONSIN,Chilton,3862.0,8,7,1
8369,WISCONSIN,Cleveland,1452.0,1,1,0
8370,WISCONSIN,Clinton,2116.0,6,6,0
8371,WISCONSIN,Clintonville,4333.0,16,12,4
8372,WISCONSIN,Colby-Abbotsford,4165.0,9,8,1
8373,WISCONSIN,Coleman,681.0,1,1,0
8374,WISCONSIN,Colfax,1150.0,2,2,0
8375,WISCONSIN,Columbus,5129.0,10,8,2
8376,WISCONSIN,Cornell,1394.0,3,3,0
8377,WISCONSIN,Cottage Grove,7241.0,15,13,2
8378,WISCONSIN,Crandon,1767.0,5,4,1
8379,WISCONSIN,Cross Plains,4348.0,7,6,1
8380,WISCONSIN,Cuba City,2043.0,8,4,4
8381,WISCONSIN,Cudahy,18201.0,39,30,9
8382,WISCONSIN,Cumberland,2090.0,7,7,0
8383,WISCONSIN,Darlington,2305.0,5,5,0
8384,WISCONSIN,Deforest,11130.0,23,20,3
8385,WISCONSIN,Delafield,7607.0,18,16,2
8386,WISCONSIN,Delavan,9813.0,27,25,2
8387,WISCONSIN,Delavan Town,5361.0,14,13,1
8388,WISCONSIN,Durand,1776.0,4,4,0
8389,WISCONSIN,Eagle River,1603.0,7,6,1
8390,WISCONSIN,Eagle Village,2213.0,2,2,0
8391,WISCONSIN,East Troy,4307.0,8,8,0
8392,WISCONSIN,Eau Claire,69372.0,128,94,34
8393,WISCONSIN,Edgar,1430.0,1,1,0
8394,WISCONSIN,Edgerton,5613.0,11,10,1
8395,WISCONSIN,Eleva,659.0,1,1,0
8396,WISCONSIN,Elkhart Lake,1018.0,3,3,0
8397,WISCONSIN,Elkhorn,10016.0,16,15,1
8398,WISCONSIN,Elk Mound,885.0,1,1,0
8399,WISCONSIN,Ellsworth,3270.0,6,6,0
8400,WISCONSIN,Elm Grove,6158.0,22,16,6
8401,WISCONSIN,Elroy,1293.0,3,3,0
8402,WISCONSIN,Evansville,5614.0,12,10,2
8403,WISCONSIN,Everest Metropolitan,17341.0,32,28,4
8404,WISCONSIN,Fall Creek,1289.0,2,2,0
8405,WISCONSIN,Fennimore,2464.0,6,6,0
8406,WISCONSIN,Fitchburg,31498.0,65,53,12
8407,WISCONSIN,Fond du Lac,43195.0,72,63,9
8408,WISCONSIN,Fontana,1749.0,8,7,1
8409,WISCONSIN,Fort Atkinson,12370.0,26,20,6
8410,WISCONSIN,Fox Crossing,19200.0,31,27,4
8411,WISCONSIN,Fox Lake,1432.0,3,3,0
8412,WISCONSIN,Fox Point,6678.0,18,17,1
8413,WISCONSIN,Fox Valley Metro,22891.0,28,26,2
8414,WISCONSIN,Franklin,36264.0,76,60,16
8415,WISCONSIN,Frederic,1075.0,4,2,2
8416,WISCONSIN,Galesville,1611.0,4,4,0
8417,WISCONSIN,Geneva Town,5052.0,8,7,1
8418,WISCONSIN,Germantown,20066.0,44,33,11
8419,WISCONSIN,Gillett,1298.0,4,4,0
8420,WISCONSIN,Glendale,12843.0,45,39,6
8421,WISCONSIN,Grafton,11783.0,50,22,28
8422,WISCONSIN,Grand Chute,23739.0,40,35,5
8423,WISCONSIN,Grand Rapids,7334.0,8,6,2
8424,WISCONSIN,Grantsburg,1292.0,4,3,1
8425,WISCONSIN,Green Bay,103826.0,213,175,38
8426,WISCONSIN,Greendale,14251.0,67,28,39
8427,WISCONSIN,Greenfield,37531.0,69,61,8
8428,WISCONSIN,Green Lake,961.0,3,3,0
8429,WISCONSIN,Hales Corners,7603.0,17,16,1
8430,WISCONSIN,Hammond,1887.0,4,3,1
8431,WISCONSIN,Hartford,15815.0,33,27,6
8432,WISCONSIN,Hartford Township,3571.0,1,1,0
8433,WISCONSIN,Hartland,9360.0,18,16,2
8434,WISCONSIN,Hayward,2353.0,8,7,1
8435,WISCONSIN,Hazel Green,1215.0,2,2,0
8436,WISCONSIN,Highland,824.0,1,1,0
8437,WISCONSIN,Hillsboro,1385.0,3,3,0
8438,WISCONSIN,Hobart-Lawrence,16712.0,13,12,1
8439,WISCONSIN,Holmen,10497.0,14,12,2
8440,WISCONSIN,Horicon,3683.0,9,8,1
8441,WISCONSIN,Hortonville,3005.0,7,6,1
8442,WISCONSIN,Hudson,14313.0,29,26,3
8443,WISCONSIN,Hurley,1413.0,7,6,1
8444,WISCONSIN,Independence,1286.0,3,3,0
8445,WISCONSIN,Iron Ridge,880.0,1,1,0
8446,WISCONSIN,Iron River,1160.0,3,3,0
8447,WISCONSIN,Jackson,7304.0,14,13,1
8448,WISCONSIN,Janesville,64768.0,112,100,12
8449,WISCONSIN,Jefferson,8042.0,17,14,3
8450,WISCONSIN,Juneau,2506.0,5,4,1
8451,WISCONSIN,Kaukauna,16444.0,27,26,1
8452,WISCONSIN,Kenosha,99588.0,427,207,220
8453,WISCONSIN,Kewaskum,4323.0,8,8,0
8454,WISCONSIN,Kewaunee,2824.0,6,6,0
8455,WISCONSIN,Kiel,3807.0,9,8,1
8456,WISCONSIN,Kronenwetter,8242.0,9,8,1
8457,WISCONSIN,La Crosse,51143.0,115,96,19
8458,WISCONSIN,Ladysmith,3022.0,8,8,0
8459,WISCONSIN,La Farge,765.0,1,1,0
8460,WISCONSIN,Lake Delton,2992.0,25,23,2
8461,WISCONSIN,Lake Geneva,8155.0,35,25,10
8462,WISCONSIN,Lake Hallie,6807.0,12,10,2
8463,WISCONSIN,Lake Mills,6044.0,12,10,2
8464,WISCONSIN,Lancaster,3683.0,8,7,1
8465,WISCONSIN,Lena,538.0,1,1,0
8466,WISCONSIN,Linn Township,2409.0,7,7,0
8467,WISCONSIN,Lomira,2457.0,5,4,1
8468,WISCONSIN,Luxemburg,2582.0,1,1,0
8469,WISCONSIN,Madison,266199.0,595,484,111
8470,WISCONSIN,Manawa,1259.0,3,3,0
8471,WISCONSIN,Manitowoc,32233.0,71,60,11
8472,WISCONSIN,Maple Bluff,1306.0,14,6,8
8473,WISCONSIN,Marathon City,1513.0,3,3,0
8474,WISCONSIN,Marinette,10421.0,28,24,4
8475,WISCONSIN,Marion,1159.0,4,4,0
8476,WISCONSIN,Markesan,1382.0,4,4,0
8477,WISCONSIN,Marshfield,18347.0,44,38,6
8478,WISCONSIN,Mayville,4798.0,9,8,1
8479,WISCONSIN,Medford,4258.0,9,8,1
8480,WISCONSIN,Menasha,17823.0,38,31,7
8481,WISCONSIN,Menomonee Falls,38516.0,73,60,13
8482,WISCONSIN,Menomonie,16633.0,31,25,6
8483,WISCONSIN,Mequon,24936.0,49,40,9
8484,WISCONSIN,Merrill,8927.0,24,21,3
8485,WISCONSIN,Middleton,20472.0,47,38,9
8486,WISCONSIN,Milton,5653.0,13,11,2
8487,WISCONSIN,Milwaukee,593337.0,2015,1654,361
8488,WISCONSIN,Mineral Point,2449.0,6,6,0
8489,WISCONSIN,Minocqua,4453.0,15,10,5
8490,WISCONSIN,Mishicot,1384.0,3,3,0
8491,WISCONSIN,Mondovi,2542.0,4,4,0
8492,WISCONSIN,Monona,8226.0,26,21,5
8493,WISCONSIN,Monroe,10387.0,31,24,7
8494,WISCONSIN,Monticello,1182.0,3,3,0
8495,WISCONSIN,Mount Horeb,7606.0,14,14,0
8496,WISCONSIN,Mount Pleasant,27084.0,63,56,7
8497,WISCONSIN,Mukwonago,8184.0,21,15,6
8498,WISCONSIN,Mukwonago Town,8184.0,7,6,1
8499,WISCONSIN,Muscoda,1227.0,3,3,0
8500,WISCONSIN,Muskego,25436.0,49,39,10
8501,WISCONSIN,Neenah,26451.0,51,40,11
8502,WISCONSIN,Neillsville,2367.0,7,6,1
8503,WISCONSIN,Nekoosa,2373.0,7,7,0
8504,WISCONSIN,New Berlin,39833.0,83,70,13
8505,WISCONSIN,New Glarus,2132.0,4,4,0
8506,WISCONSIN,New Holstein,3092.0,6,5,1
8507,WISCONSIN,New Lisbon,2547.0,3,3,0
8508,WISCONSIN,New London,7043.0,19,17,2
8509,WISCONSIN,New Richmond,9875.0,19,18,1
8510,WISCONSIN,Niagara,1526.0,4,4,0
8511,WISCONSIN,North Fond du Lac,5064.0,8,7,1
8512,WISCONSIN,Norwalk,631.0,1,1,0
8513,WISCONSIN,Oak Creek,36975.0,86,62,24
8514,WISCONSIN,Oakfield Village,1089.0,3,3,0
8515,WISCONSIN,Oconomowoc,17301.0,31,26,5
8516,WISCONSIN,Oconomowoc Lake,611.0,6,6,0
8517,WISCONSIN,Oconomowoc Town,8801.0,11,10,1
8518,WISCONSIN,Omro,3599.0,8,7,1
8519,WISCONSIN,Onalaska,19243.0,32,30,2
8520,WISCONSIN,Oregon,10881.0,22,19,3
8521,WISCONSIN,Orfordville,1490.0,3,3,0
8522,WISCONSIN,Osceola,2582.0,6,5,1
8523,WISCONSIN,Oshkosh,66513.0,111,95,16
8524,WISCONSIN,Osseo,1668.0,4,4,0
8525,WISCONSIN,Palmyra,1742.0,12,6,6
8526,WISCONSIN,Park Falls,2168.0,7,7,0
8527,WISCONSIN,Pepin,739.0,1,1,0
8528,WISCONSIN,Peshtigo,3310.0,6,6,0
8529,WISCONSIN,Pewaukee Village,8089.0,39,19,20
8530,WISCONSIN,Phillips,1306.0,5,5,0
8531,WISCONSIN,Pittsville,815.0,2,2,0
8532,WISCONSIN,Plainfield,829.0,2,1,1
8533,WISCONSIN,Platteville,11690.0,23,20,3
8534,WISCONSIN,Pleasant Prairie,21542.0,44,34,10
8535,WISCONSIN,Plover,13360.0,23,20,3
8536,WISCONSIN,Plymouth,8766.0,15,14,1
8537,WISCONSIN,Portage,10387.0,29,25,4
8538,WISCONSIN,Port Edwards,1746.0,3,3,0
8539,WISCONSIN,Port Washington,12147.0,24,19,5
8540,WISCONSIN,Prescott,4281.0,11,10,1
8541,WISCONSIN,Princeton,1162.0,4,4,0
8542,WISCONSIN,Pulaski,3789.0,8,7,1
8543,WISCONSIN,Racine,76018.0,201,175,26
8544,WISCONSIN,Reedsburg,9521.0,27,20,7
8545,WISCONSIN,Rhinelander,7624.0,18,16,2
8546,WISCONSIN,Rice Lake,8511.0,19,18,1
8547,WISCONSIN,Richland Center,4920.0,13,11,2
8548,WISCONSIN,Rio,1047.0,2,2,0
8549,WISCONSIN,Ripon,7856.0,16,14,2
8550,WISCONSIN,River Hills,1585.0,11,11,0
8551,WISCONSIN,Rome Town,2790.0,6,6,0
8552,WISCONSIN,Rosendale,1023.0,1,1,0
8553,WISCONSIN,Rothschild,5255.0,14,12,2
8554,WISCONSIN,Sauk Prairie,4666.0,15,13,2
8555,WISCONSIN,Saukville,4436.0,13,11,2
8556,WISCONSIN,Seymour,3457.0,6,6,0
8557,WISCONSIN,Sharon,1541.0,5,4,1
8558,WISCONSIN,Shawano,8845.0,23,21,2
8559,WISCONSIN,Sheboygan,47667.0,103,83,20
8560,WISCONSIN,Sheboygan Falls,7924.0,15,13,2
8561,WISCONSIN,Shiocton,914.0,2,2,0
8562,WISCONSIN,Shorewood,13222.0,28,24,4
8563,WISCONSIN,Shorewood Hills,2050.0,8,7,1
8564,WISCONSIN,Shullsburg,1188.0,1,1,0
8565,WISCONSIN,Siren,778.0,4,3,1
8566,WISCONSIN,Slinger,5770.0,13,12,1
8567,WISCONSIN,Somerset,3027.0,7,6,1
8568,WISCONSIN,South Milwaukee,20795.0,40,34,6
8569,WISCONSIN,Sparta,9827.0,22,20,2
8570,WISCONSIN,Spencer,1859.0,4,4,0
8571,WISCONSIN,Spooner,2539.0,8,7,1
8572,WISCONSIN,Spring Green,1631.0,4,3,1
8573,WISCONSIN,Spring Valley,1321.0,2,1,1
8574,WISCONSIN,Stanley,3714.0,5,5,0
8575,WISCONSIN,St. Croix Falls,2052.0,8,7,1
8576,WISCONSIN,Stevens Point,25875.0,49,45,4
8577,WISCONSIN,St. Francis,9846.0,22,21,1
8578,WISCONSIN,Stoughton,13274.0,28,22,6
8579,WISCONSIN,Strum,1068.0,2,2,0
8580,WISCONSIN,Sturgeon Bay,8970.0,24,22,2
8581,WISCONSIN,Sturtevant,6642.0,12,11,1
8582,WISCONSIN,Summit,5321.0,11,10,1
8583,WISCONSIN,Sun Prairie,35722.0,72,51,21
8584,WISCONSIN,Superior,26117.0,62,57,5
8585,WISCONSIN,Theresa,1193.0,2,2,0
8586,WISCONSIN,Thiensville,3107.0,9,8,1
8587,WISCONSIN,Thorp,1602.0,3,3,0
8588,WISCONSIN,Three Lakes,2126.0,5,5,0
8589,WISCONSIN,Tomah,9379.0,23,21,2
8590,WISCONSIN,Tomahawk,3107.0,10,9,1
8591,WISCONSIN,Town of East Troy,4065.0,6,5,1
8592,WISCONSIN,Town of Madison,6713.0,9,8,1
8593,WISCONSIN,Twin Lakes,6261.0,18,13,5
8594,WISCONSIN,Two Rivers,10903.0,29,25,4
8595,WISCONSIN,Verona,13860.0,28,25,3
8596,WISCONSIN,Viroqua,4398.0,12,10,2
8597,WISCONSIN,Walworth,2828.0,9,8,1
8598,WISCONSIN,Waterford Town,6509.0,10,9,1
8599,WISCONSIN,Waterloo,3320.0,8,7,1
8600,WISCONSIN,Watertown,23322.0,54,39,15
8601,WISCONSIN,Waukesha,72493.0,153,123,30
8602,WISCONSIN,Waupaca,5833.0,18,17,1
8603,WISCONSIN,Waupun,11264.0,16,14,2
8604,WISCONSIN,Wausau,38435.0,88,79,9
8605,WISCONSIN,Wautoma,2106.0,7,6,1
8606,WISCONSIN,Wauwatosa,48650.0,114,93,21
8607,WISCONSIN,Webster,618.0,2,2,0
8608,WISCONSIN,West Allis,60176.0,149,122,27
8609,WISCONSIN,West Bend,31506.0,74,57,17
8610,WISCONSIN,Westfield,1270.0,1,1,0
8611,WISCONSIN,West Milwaukee,4113.0,23,19,4
8612,WISCONSIN,West Salem,5032.0,10,9,1
8613,WISCONSIN,Whitefish Bay,13848.0,22,21,1
8614,WISCONSIN,Whitewater,15057.0,54,23,31
8615,WISCONSIN,Wild Rose,644.0,1,1,0
8616,WISCONSIN,Williams Bay,2666.0,8,8,0
8617,WISCONSIN,Winneconne,2491.0,6,5,1
8618,WISCONSIN,Wisconsin Dells,3099.0,19,15,4
8619,WISCONSIN,Woodruff,1990.0,6,5,1
8620,WYOMING,Afton,2086.0,4,4,0
8621,WYOMING,Buffalo,4666.0,16,9,7
8622,WYOMING,Casper,58840.0,150,101,49
8623,WYOMING,Cheyenne,65263.0,120,102,18
8624,WYOMING,Cody,9878.0,26,23,3
8625,WYOMING,Diamondville,769.0,2,2,0
8626,WYOMING,Douglas,6404.0,18,15,3
8627,WYOMING,Evanston,11494.0,31,26,5
8628,WYOMING,Evansville,3046.0,14,12,2
8629,WYOMING,Gillette,32294.0,76,51,25
8630,WYOMING,Glenrock,2560.0,12,6,6
8631,WYOMING,Green River,11729.0,31,26,5
8632,WYOMING,Greybull,1792.0,7,6,1
8633,WYOMING,Hanna,749.0,1,1,0
8634,WYOMING,Jackson,10672.0,39,31,8
8635,WYOMING,Kemmerer,2775.0,5,5,0
8636,WYOMING,Lander,7452.0,20,18,2
8637,WYOMING,Laramie,32841.0,68,44,24
8638,WYOMING,Lusk,1465.0,7,6,1
8639,WYOMING,Mills,4144.0,15,15,0
8640,WYOMING,Moorcroft,1091.0,4,3,1
8641,WYOMING,Newcastle,3293.0,16,7,9
8642,WYOMING,Pine Bluffs,1163.0,3,3,0
8643,WYOMING,Powell,6108.0,23,16,7
8644,WYOMING,Rawlins,8413.0,25,14,11
8645,WYOMING,Riverton,10823.0,40,29,11
8646,WYOMING,Rock Springs,22937.0,46,36,10
8647,WYOMING,Saratoga,1591.0,6,3,3
8648,WYOMING,Sheridan,18157.0,46,29,17
8649,WYOMING,Thermopolis,2747.0,11,6,5
8650,WYOMING,Torrington,6564.0,22,15,7
8651,WYOMING,Wheatland,3512.0,10,9,1
8652,WYOMING,Worland,4947.0,13,12,1
